Id,pcode,typhoon,Year,Totally,Partially,total
1,PH041005000,Durian,2006,84,588,672
2,PH041006000,Durian,2006,1,7,8
3,PH041010000,Durian,2006,4,48,52
4,PH041014000,Durian,2006,0,78,78
5,PH041020000,Durian,2006,16,169,185
6,PH041021000,Durian,2006,45,183,228
7,PH041023000,Durian,2006,0,38,38
8,PH041025000,Durian,2006,9,124,133
9,PH041027000,Durian,2006,0,58,58
10,PH041029000,Durian,2006,1,7,8
11,PH041031000,Durian,2006,10,21,31
12,PH041032000,Durian,2006,37,332,369
13,PH043401000,Durian,2006,30,31,61
14,PH043411000,Durian,2006,0,5,5
15,PH042113000,Durian,2006,0,6,6
16,PH045603000,Durian,2006,0,120,120
17,PH045615000,Durian,2006,27,289,316
18,PH045616000,Durian,2006,167,94,261
19,PH045624000,Durian,2006,5,39,44
20,PH045625000,Durian,2006,74,834,908
21,PH045628000,Durian,2006,571,766,1337
22,PH045630000,Durian,2006,12,20,32
23,PH045634000,Durian,2006,83,645,728
24,PH031417000,Durian,2006,3,103,106
25,PH034924000,Durian,2006,66,299,365
26,PH072242000,Durian,2006,1869,459,2328
27,PH037112000,Durian,2006,2325,6566,8891
28,PH045645000,Durian,2006,23,255,278
29,PH045648000,Durian,2006,7,66,73
30,PH175101000,Durian,2006,261,618,879
31,PH175104000,Durian,2006,7,112,119
32,PH175106000,Durian,2006,35,83,118
33,PH175109000,Durian,2006,45,0,45
34,PH175107000,Durian,2006,28,38,66
35,PH175111000,Durian,2006,144,165,309
36,PH175205000,Durian,2006,284,602,886
37,PH175201000,Durian,2006,1368,2758,4126
38,PH175203000,Durian,2006,0,7,7
39,PH175206000,Durian,2006,38,560,598
40,PH175208000,Durian,2006,2730,6563,9293
41,PH175209000,Durian,2006,0,1740,1740
42,PH175210000,Durian,2006,118,969,1087
43,PH175211000,Durian,2006,452,156,608
44,PH023126000,Durian,2006,0,67,67
45,PH175213000,Durian,2006,192,700,892
46,PH166723000,Durian,2006,101,316,417
47,PH174001000,Durian,2006,348,692,1040
48,PH174004000,Durian,2006,249,498,747
49,PH174002000,Durian,2006,157,314,471
50,PH174005000,Durian,2006,442,885,1327
51,PH174006000,Durian,2006,221,442,663
52,PH174003000,Durian,2006,237,474,711
53,PH051701000,Durian,2006,120,50,170
54,PH051703000,Durian,2006,4875,2088,6963
55,PH051704000,Durian,2006,746,1700,2446
56,PH051702000,Durian,2006,10,435,445
57,PH051705000,Durian,2006,7133,4280,11413
58,PH051706000,Durian,2006,1562,3765,5327
59,PH051707000,Durian,2006,1934,1608,3542
60,PH051708000,Durian,2006,3568,6879,10447
61,PH051709000,Durian,2006,1208,3614,4822
62,PH051711000,Durian,2006,550,3775,4325
63,PH051710000,Durian,2006,900,788,1688
64,PH051712000,Durian,2006,81,363,444
65,PH051713000,Durian,2006,423,1094,1517
66,PH051714000,Durian,2006,223,1797,2020
67,PH051715000,Durian,2006,1888,941,2829
68,PH051716000,Durian,2006,297,402,699
69,PH051717000,Durian,2006,1524,6638,8162
70,PH051718000,Durian,2006,4824,45350,50174
71,PH051719000,Durian,2006,223,520,743
72,PH051720000,Durian,2006,965,1607,2572
73,PH051722000,Durian,2006,2892,2907,5799
74,PH051721000,Durian,2006,68,77,145
75,PH051723000,Durian,2006,3054,4505,7559
76,PH051724000,Durian,2006,2980,5775,8755
77,PH051725000,Durian,2006,25951,39409,65360
78,PH021518000,Durian,2006,4688,6300,10988
79,PH051727000,Durian,2006,3865,9546,13411
80,PH051728000,Durian,2006,2500,4000,6500
81,PH051729000,Durian,2006,733,1114,1847
82,PH051730000,Durian,2006,780,5995,6775
83,PH051731000,Durian,2006,3287,1734,5021
84,PH051732000,Durian,2006,1840,2543,4383
85,PH051733000,Durian,2006,181,733,914
86,PH051734000,Durian,2006,185,1576,1761
87,PH051735000,Durian,2006,358,890,1248
88,PH051736000,Durian,2006,6883,1963,8846
89,PH051737000,Durian,2006,1546,5189,6735
90,PH052003000,Durian,2006,2307,2085,4392
91,PH052001000,Durian,2006,225,1846,2071
92,PH052002000,Durian,2006,1319,1392,2711
93,PH052004000,Durian,2006,538,2276,2814
94,PH052005000,Durian,2006,246,831,1077
95,PH052006000,Durian,2006,94,1217,1311
96,PH052007000,Durian,2006,152,1458,1610
97,PH052008000,Durian,2006,3477,3477,6954
98,PH052009000,Durian,2006,1616,1395,3011
99,PH052010000,Durian,2006,219,989,1208
100,PH052011000,Durian,2006,5740,7267,13007
101,PH050501000,Durian,2006,5648,2231,7879
102,PH050502000,Durian,2006,6526,5502,12028
103,PH051709000,Durian,2006,303,329,632
104,PH050503000,Durian,2006,5586,6553,12139
105,PH050504000,Durian,2006,5103,4698,9801
106,PH050505000,Durian,2006,2124,2323,4447
107,PH050506000,Durian,2006,4668,9972,14640
108,PH050508000,Durian,2006,3793,6118,9911
109,PH050507000,Durian,2006,2215,1669,3884
110,PH050510000,Durian,2006,7000,1400,8400
111,PH050509000,Durian,2006,6187,1127,7314
112,PH050511000,Durian,2006,3027,2154,5181
113,PH050512000,Durian,2006,6920,2778,9698
114,PH050513000,Durian,2006,2016,5671,7687
115,PH050514000,Durian,2006,4770,2072,6842
116,PH050515000,Durian,2006,2652,1184,3836
117,PH050516000,Durian,2006,3816,3106,6922
118,PH050517000,Durian,2006,8905,5426,14331
119,PH050518000,Durian,2006,4184,5484,9668
120,PH051601000,Durian,2006,51,368,419
121,PH051603000,Durian,2006,0,5,5
122,PH051605000,Durian,2006,1,33,34
123,PH051606000,Durian,2006,304,3935,4239
124,PH051604000,Durian,2006,2,35,37
125,PH051609000,Durian,2006,6,525,531
126,PH054120000,Durian,2006,2757,1496,4253
127,PH054107000,Durian,2006,30,40,70
128,PH054101000,Durian,2006,2,0,2
129,PH056205000,Durian,2006,346,1043,1389
130,PH056204000,Durian,2006,38,1342,1380
131,PH056212000,Durian,2006,136,6657,6793
132,PH056213000,Durian,2006,1580,5750,7330
133,PH037110000,Fengshen,2008,3,6,9
134,PH035412000,Fengshen,2008,0,50,50
135,PH035413000,Fengshen,2008,0,2,2
136,PH030805000,Fengshen,2008,0,46,46
137,PH030808000,Fengshen,2008,0,22,22
138,PH042105000,Fengshen,2008,175,4,179
139,PH042106000,Fengshen,2008,0,700,700
140,PH042123000,Fengshen,2008,8,7,15
141,PH042115000,Fengshen,2008,0,3,3
142,PH041020000,Fengshen,2008,1,22,23
143,PH041008000,Fengshen,2008,0,3,3
144,PH041016000,Fengshen,2008,1,0,1
145,PH041023000,Fengshen,2008,43,1429,1472
146,PH041005000,Fengshen,2008,0,108,108
147,PH041019000,Fengshen,2008,0,79,79
148,PH041010000,Fengshen,2008,0,8,8
149,PH041021000,Fengshen,2008,4,172,176
150,PH041027000,Fengshen,2008,0,7,7
151,PH041003000,Fengshen,2008,0,1,1
152,PH041001000,Fengshen,2008,1,0,1
153,PH041014000,Fengshen,2008,0,4,4
154,PH041031000,Fengshen,2008,0,50,50
155,PH041032000,Fengshen,2008,0,13,13
156,PH041006000,Fengshen,2008,0,10,10
157,PH041026000,Fengshen,2008,1,0,1
158,PH045601000,Fengshen,2008,475,856,1331
159,PH045603000,Fengshen,2008,90,424,514
160,PH045607999,Fengshen,2008,11,111,122
161,PH045615000,Fengshen,2008,250,70,320
162,PH045619000,Fengshen,2008,33,402,435
163,PH045619999,Fengshen,2008,320,194,514
164,PH045624000,Fengshen,2008,0,0,0
165,PH045625000,Fengshen,2008,60,2500,2560
166,PH045627000,Fengshen,2008,264,814,1078
167,PH045630000,Fengshen,2008,46,2543,2589
168,PH045634000,Fengshen,2008,218,2709,2927
169,PH045640999,Fengshen,2008,0,154,154
170,PH045645000,Fengshen,2008,295,2387,2682
171,PH045643999,Fengshen,2008,100,52,152
172,PH045649000,Fengshen,2008,580,1500,2080
173,PH045633000,Fengshen,2008,38,371,409
174,PH045629000,Fengshen,2008,536,1335,1871
175,PH045616000,Fengshen,2008,54,42,96
176,PH045647000,Fengshen,2008,52,184,236
177,PH045806000,Fengshen,2008,14,60,74
178,PH045804000,Fengshen,2008,0,15,15
179,PH045812000,Fengshen,2008,7,50,57
180,PH045807000,Fengshen,2008,31,4,35
181,PH043401000,Fengshen,2008,1,40,41
182,PH043402000,Fengshen,2008,14,42,56
183,PH043405000,Fengshen,2008,0,0,0
184,PH043409000,Fengshen,2008,81,255,336
185,PH043411000,Fengshen,2008,0,15,15
186,PH043418000,Fengshen,2008,6,19,25
187,PH043419000,Fengshen,2008,14,130,144
188,PH043421000,Fengshen,2008,36,41,77
189,PH043422000,Fengshen,2008,36,441,477
190,PH021521000,Fengshen,2008,5,25,30
191,PH043424000,Fengshen,2008,0,5,5
192,PH043428000,Fengshen,2008,0,0,0
193,PH043426000,Fengshen,2008,38,1157,1195
194,PH043429999,Fengshen,2008,14,270,284
195,PH043410000,Fengshen,2008,69,272,341
196,PH043406000,Fengshen,2008,8,41,49
197,PH043417000,Fengshen,2008,21,161,182
198,PH043407000,Fengshen,2008,5,54,59
199,PH043408000,Fengshen,2008,17,290,307
200,PH043415000,Fengshen,2008,10,505,515
201,PH043416000,Fengshen,2008,36,193,229
202,PH043429000,Fengshen,2008,44,122,166
203,PH043426999,Fengshen,2008,0,0,0
204,PH043420000,Fengshen,2008,0,0,0
205,PH175910999,Fengshen,2008,646,2053,2699
206,PH175917000,Fengshen,2008,104,114,218
207,PH175913999,Fengshen,2008,1,0,1
208,PH175914999,Fengshen,2008,99,1285,1384
209,PH175909000,Fengshen,2008,16,352,368
210,PH175916000,Fengshen,2008,12,47,59
211,PH175103000,Fengshen,2008,82,161,243
212,PH175912000,Fengshen,2008,7,175,182
213,PH175901000,Fengshen,2008,235,768,1003
214,PH175905000,Fengshen,2008,100,0,100
215,PH175903000,Fengshen,2008,214,387,601
216,PH175906000,Fengshen,2008,261,2176,2437
217,PH175912999,Fengshen,2008,0,39,39
218,PH174001000,Fengshen,2008,55,1177,1232
219,PH174001999,Fengshen,2008,25,10,35
220,PH174004000,Fengshen,2008,23,95,118
221,PH174004999,Fengshen,2008,3,16,19
222,PH174006000,Fengshen,2008,4,30,34
223,PH174003000,Fengshen,2008,57,836,893
224,PH175107999,Fengshen,2008,79,0,79
225,PH175104999,Fengshen,2008,25,10,35
226,PH175204000,Fengshen,2008,79,0,79
227,PH175209000,Fengshen,2008,25,10,35
228,PH175207000,Fengshen,2008,2,0,2
229,PH054102000,Fengshen,2008,0,34,34
230,PH054103000,Fengshen,2008,956,1643,2599
231,PH054104000,Fengshen,2008,0,18,18
232,PH054105000,Fengshen,2008,20,765,785
233,PH054106000,Fengshen,2008,106,616,722
234,PH054106999,Fengshen,2008,0,140,140
235,PH054108000,Fengshen,2008,13,248,261
236,PH054109000,Fengshen,2008,21,642,663
237,PH054110000,Fengshen,2008,2,20,22
238,PH054111000,Fengshen,2008,0,486,486
239,PH054112000,Fengshen,2008,55,405,460
240,PH054113000,Fengshen,2008,5,60,65
241,PH054115000,Fengshen,2008,5,16,21
242,PH054116000,Fengshen,2008,9,459,468
243,PH054121000,Fengshen,2008,29,104,133
244,PH054117000,Fengshen,2008,207,1727,1934
245,PH060401000,Fengshen,2008,80,598,678
246,PH060401999,Fengshen,2008,127,985,1112
247,PH060403000,Fengshen,2008,928,2502,3430
248,PH060404000,Fengshen,2008,319,1693,2012
249,PH060405000,Fengshen,2008,222,2502,2724
250,PH060406000,Fengshen,2008,522,1693,2215
251,PH060407000,Fengshen,2008,4405,5561,9966
252,PH060408000,Fengshen,2008,213,1581,1794
253,PH060409000,Fengshen,2008,200,1500,1700
254,PH060410000,Fengshen,2008,250,1200,1450
255,PH060411000,Fengshen,2008,587,2537,3124
256,PH060412000,Fengshen,2008,7,239,246
257,PH060412999,Fengshen,2008,29,529,558
258,PH060414000,Fengshen,2008,74,421,495
259,PH060416000,Fengshen,2008,3614,2559,6173
260,PH060417000,Fengshen,2008,327,1457,1784
261,PH060415000,Fengshen,2008,946,2988,3934
262,PH063001000,Fengshen,2008,182,1451,1633
263,PH063002000,Fengshen,2008,92,283,375
264,PH063003000,Fengshen,2008,500,700,1200
265,PH063004000,Fengshen,2008,10,99,109
266,PH063005000,Fengshen,2008,2029,3035,5064
267,PH063006000,Fengshen,2008,81,640,721
268,PH063007000,Fengshen,2008,154,539,693
269,PH063008000,Fengshen,2008,129,1225,1354
270,PH063009000,Fengshen,2008,420,978,1398
271,PH063010000,Fengshen,2008,0,8,8
272,PH063011999,Fengshen,2008,113,682,795
273,PH063013000,Fengshen,2008,252,916,1168
274,PH063014000,Fengshen,2008,3375,5492,8867
275,PH063014999,Fengshen,2008,331,2474,2805
276,PH063016000,Fengshen,2008,240,1404,1644
277,PH063017000,Fengshen,2008,53,676,729
278,PH063018000,Fengshen,2008,175,490,665
279,PH063019000,Fengshen,2008,1987,4155,6142
280,PH063020000,Fengshen,2008,40,329,369
281,PH063021000,Fengshen,2008,62,850,912
282,PH063023000,Fengshen,2008,2123,2923,5046
283,PH063025000,Fengshen,2008,303,914,1217
284,PH063026000,Fengshen,2008,985,1179,2164
285,PH063026999,Fengshen,2008,1705,186,1891
286,PH063028000,Fengshen,2008,215,101,316
287,PH063029000,Fengshen,2008,207,151,358
288,PH063030000,Fengshen,2008,6,56,62
289,PH063031000,Fengshen,2008,286,589,875
290,PH063032000,Fengshen,2008,30,279,309
291,PH063034000,Fengshen,2008,150,713,863
292,PH063035000,Fengshen,2008,217,981,1198
293,PH063036000,Fengshen,2008,1182,3060,4242
294,PH063037000,Fengshen,2008,544,2338,2882
295,PH063038000,Fengshen,2008,352,1020,1372
296,PH063039000,Fengshen,2008,179,1999,2178
297,PH063040000,Fengshen,2008,22,250,272
298,PH063041000,Fengshen,2008,580,303,883
299,PH063042000,Fengshen,2008,76,407,483
300,PH063044000,Fengshen,2008,191,3309,3500
301,PH063042999,Fengshen,2008,2609,954,3563
302,PH063045000,Fengshen,2008,370,860,1230
303,PH063046000,Fengshen,2008,40,112,152
304,PH063047000,Fengshen,2008,5300,964,6264
305,PH063022000,Fengshen,2008,1891,5488,7379
306,PH060601000,Fengshen,2008,35,107,142
307,PH060602000,Fengshen,2008,298,1361,1659
308,PH060603000,Fengshen,2008,57,138,195
309,PH060604000,Fengshen,2008,306,851,1157
310,PH060605000,Fengshen,2008,0,7,7
311,PH060606000,Fengshen,2008,308,548,856
312,PH060608000,Fengshen,2008,0,0,0
313,PH060609000,Fengshen,2008,417,968,1385
314,PH060610000,Fengshen,2008,9,238,247
315,PH060610999,Fengshen,2008,73,874,947
316,PH060612000,Fengshen,2008,101,610,711
317,PH060613000,Fengshen,2008,371,251,622
318,PH060614000,Fengshen,2008,700,505,1205
319,PH060615000,Fengshen,2008,109,275,384
320,PH060616000,Fengshen,2008,356,1943,2299
321,PH060617000,Fengshen,2008,320,502,822
322,PH060607000,Fengshen,2008,1,55,56
323,PH060618000,Fengshen,2008,159,212,371
324,PH067903000,Fengshen,2008,21,168,189
325,PH067900999,Fengshen,2008,30,315,345
326,PH067905000,Fengshen,2008,7,34,41
327,PH067902000,Fengshen,2008,7,55,62
328,PH067904000,Fengshen,2008,1,5,6
329,PH061901000,Fengshen,2008,13,73,86
330,PH061903000,Fengshen,2008,32,999,1031
331,PH061904000,Fengshen,2008,42,260,302
332,PH061905000,Fengshen,2008,395,1631,2026
333,PH061906000,Fengshen,2008,30,200,230
334,PH061907000,Fengshen,2008,267,1731,1998
335,PH061908000,Fengshen,2008,22,200,222
336,PH061909000,Fengshen,2008,934,2970,3904
337,PH061910000,Fengshen,2008,283,1736,2019
338,PH061911000,Fengshen,2008,1044,3728,4772
339,PH061912000,Fengshen,2008,266,2113,2379
340,PH061913000,Fengshen,2008,280,1489,1769
341,PH061914000,Fengshen,2008,3343,14472,17815
342,PH061915000,Fengshen,2008,278,1751,2029
343,PH061916000,Fengshen,2008,0,0,0
344,PH061917000,Fengshen,2008,35,495,530
345,PH184501000,Fengshen,2008,54,614,668
346,PH184502000,Fengshen,2008,5,18,23
347,PH184503000,Fengshen,2008,59,19,78
348,PH184504000,Fengshen,2008,0,0,0
349,PH184504999,Fengshen,2008,5,18,23
350,PH184507000,Fengshen,2008,19,2,21
351,PH184508000,Fengshen,2008,3,38,41
352,PH184511000,Fengshen,2008,6,47,53
353,PH184512000,Fengshen,2008,1,56,57
354,PH061905000,Fengshen,2008,223,534,757
355,PH184518000,Fengshen,2008,15,39,54
356,PH184519000,Fengshen,2008,1,2,3
357,PH184520000,Fengshen,2008,1,3,4
358,PH184520999,Fengshen,2008,29,248,277
359,PH184522000,Fengshen,2008,18,221,239
360,PH184523000,Fengshen,2008,68,83,151
361,PH184532000,Fengshen,2008,2,9,11
362,PH184524999,Fengshen,2008,3,11,14
363,PH184526000,Fengshen,2008,1,5,6
364,PH184527000,Fengshen,2008,3,5,8
365,PH184527999,Fengshen,2008,12,27,39
366,PH184530000,Fengshen,2008,23,157,180
367,PH184531000,Fengshen,2008,48,1615,1663
368,PH071223000,Fengshen,2008,3,0,3
369,PH072209000,Fengshen,2008,1400,5376,6776
370,PH072242999,Fengshen,2008,237,1480,1717
371,PH072250000,Fengshen,2008,38,264,302
372,PH072243999,Fengshen,2008,909,2520,3429
373,PH072231000,Fengshen,2008,280,2347,2627
374,PH072248000,Fengshen,2008,16,423,439
375,PH072252000,Fengshen,2008,3,19,22
376,PH072249000,Fengshen,2008,8,179,187
377,PH072220000,Fengshen,2008,0,1500,1500
378,PH072242000,Fengshen,2008,4,3,7
379,PH072221000,Fengshen,2008,856,6061,6917
380,PH072238000,Fengshen,2008,0,4,4
381,PH072235999,Fengshen,2008,0,6,6
382,PH072211000,Fengshen,2008,73,1906,1979
383,PH072228000,Fengshen,2008,1363,2818,4181
384,PH071247000,Fengshen,2008,0,8,8
385,PH087801000,Fengshen,2008,75,572,647
386,PH087802000,Fengshen,2008,132,1419,1551
387,PH087803000,Fengshen,2008,86,367,453
388,PH087804000,Fengshen,2008,184,946,1130
389,PH087805000,Fengshen,2008,175,1468,1643
390,PH087806000,Fengshen,2008,52,503,555
391,PH087807000,Fengshen,2008,16,461,477
392,PH087808000,Fengshen,2008,137,1840,1977
393,PH082601000,Fengshen,2008,0,0,0
394,PH082602000,Fengshen,2008,95,1641,1736
395,PH082603000,Fengshen,2008,35,892,927
396,PH082604000,Fengshen,2008,199,1101,1300
397,PH082605000,Fengshen,2008,0,2,2
398,PH082605999,Fengshen,2008,0,0,0
399,PH082607000,Fengshen,2008,65,2054,2119
400,PH082608000,Fengshen,2008,0,0,0
401,PH082609000,Fengshen,2008,236,5685,5921
402,PH082610000,Fengshen,2008,16,1474,1490
403,PH082612000,Fengshen,2008,22,1986,2008
404,PH082613000,Fengshen,2008,17,178,195
405,PH082615000,Fengshen,2008,25,46,71
406,PH082615999,Fengshen,2008,0,100,100
407,PH082618000,Fengshen,2008,0,0,0
408,PH082619000,Fengshen,2008,45,2511,2556
409,PH082622000,Fengshen,2008,0,150,150
410,PH082620000,Fengshen,2008,43,567,610
411,PH082623000,Fengshen,2008,0,0,0
412,PH083701000,Fengshen,2008,0,0,0
413,PH083703000,Fengshen,2008,0,0,0
414,PH083708000,Fengshen,2008,88,941,1029
415,PH083706999,Fengshen,2008,2,45,47
416,PH083710000,Fengshen,2008,0,23,23
417,PH083713000,Fengshen,2008,17,555,572
418,PH083715000,Fengshen,2008,2092,4832,6924
419,PH083719000,Fengshen,2008,24,87,111
420,PH083720000,Fengshen,2008,20,18,38
421,PH083721000,Fengshen,2008,1,1,2
422,PH083722000,Fengshen,2008,13,15,28
423,PH083726000,Fengshen,2008,152,1131,1283
424,PH083731000,Fengshen,2008,0,0,0
425,PH083733000,Fengshen,2008,65,67,132
426,PH083736000,Fengshen,2008,19,43,62
427,PH083738000,Fengshen,2008,47,282,329
428,PH083739000,Fengshen,2008,1,362,363
429,PH083740000,Fengshen,2008,46,3845,3891
430,PH083741999,Fengshen,2008,55,963,1018
431,PH083745000,Fengshen,2008,165,1854,2019
432,PH083747000,Fengshen,2008,219,10286,10505
433,PH083748000,Fengshen,2008,0,0,0
434,PH083749000,Fengshen,2008,6,0,6
435,PH083750000,Fengshen,2008,10,290,300
436,PH083751000,Fengshen,2008,70,350,420
437,PH086002000,Fengshen,2008,12000,23000,35000
438,PH086003000,Fengshen,2008,1,0,1
439,PH086004000,Fengshen,2008,5,1677,1682
440,PH086005000,Fengshen,2008,83,255,338
441,PH086008000,Fengshen,2008,122,1026,1148
442,PH086010000,Fengshen,2008,300,3500,3800
443,PH086012000,Fengshen,2008,0,0,0
444,PH086013000,Fengshen,2008,748,2398,3146
445,PH086015000,Fengshen,2008,27,683,710
446,PH086016000,Fengshen,2008,3,94,97
447,PH086016999,Fengshen,2008,28,174,202
448,PH086019000,Fengshen,2008,0,0,0
449,PH086021000,Fengshen,2008,823,973,1796
450,PH086023000,Fengshen,2008,135,2049,2184
451,PH086402000,Fengshen,2008,7,1,8
452,PH086404000,Fengshen,2008,0,10,10
453,PH086407000,Fengshen,2008,4,110,114
454,PH086412000,Fengshen,2008,0,10,10
455,PH086416000,Fengshen,2008,0,0,0
456,PH086418000,Fengshen,2008,0,0,0
457,PH097332000,Fengshen,2008,23,9,32
458,PH097202000,Fengshen,2008,18,71,89
459,PH097203000,Fengshen,2008,75,67,142
460,PH128005000,Fengshen,2008,42,0,42
461,PH128004000,Fengshen,2008,244,21,265
462,PH128003000,Fengshen,2008,3,352,355
463,PH126509000,Fengshen,2008,0,25,25
464,PH124701000,Fengshen,2008,1,0,1
465,PH126303000,Fengshen,2008,43,155,198
466,PH126313000,Fengshen,2008,13,0,13
467,PH126319000,Fengshen,2008,7,28,35
468,PH153812000,Fengshen,2008,75,32,107
469,PH153824000,Fengshen,2008,4,0,4
470,PH153830000,Fengshen,2008,26,20,46
471,PH153807000,Fengshen,2008,58,68,126
472,PH153817000,Fengshen,2008,192,0,192
473,PH153816000,Fengshen,2008,55,0,55
474,PH153808000,Fengshen,2008,40,0,40
475,PH153632000,Fengshen,2008,2,0,2
476,PH153614000,Fengshen,2008,8,0,8
477,PH153615000,Fengshen,2008,2,0,2
478,PH153609000,Fengshen,2008,7,0,7
479,PH031403000,ketsana,2009,48,250,298
480,PH031404000,ketsana,2009,28,4,32
481,PH031405000,ketsana,2009,1,2,3
482,PH031406000,ketsana,2009,144,68,212
483,PH031412000,ketsana,2009,19,0,19
484,PH031413000,ketsana,2009,82,53,135
485,PH031414000,ketsana,2009,7,25,32
486,PH031417000,ketsana,2009,21,2,23
487,PH031418000,ketsana,2009,177,0,177
488,PH031419000,ketsana,2009,6,0,6
489,PH031420000,ketsana,2009,1,8,9
490,PH031421000,ketsana,2009,7,25,32
491,PH031423000,ketsana,2009,2,0,2
492,PH035417000,ketsana,2009,4,4,8
493,PH035419000,ketsana,2009,6,60,66
494,PH035405000,ketsana,2009,0,20,20
495,PH035407000,ketsana,2009,10,0,10
496,PH035403000,ketsana,2009,20,0,20
497,PH035401000,ketsana,2009,20,16,36
498,PH035414000,ketsana,2009,4,4,8
499,PH037101000,ketsana,2009,726,327,1053
500,PH030805000,ketsana,2009,3,0,3
501,PH034912000,ketsana,2009,0,5,5
502,PH034924000,ketsana,2009,0,10,10
503,PH041001000,ketsana,2009,10,43,53
504,PH041003000,ketsana,2009,38,40,78
505,PH041005000,ketsana,2009,0,2,2
506,PH041006000,ketsana,2009,1,0,1
507,PH041007000,ketsana,2009,25,21,46
508,PH041011000,ketsana,2009,0,25,25
509,PH041012000,ketsana,2009,6,9,15
510,PH041013000,ketsana,2009,93,204,297
511,PH041014000,ketsana,2009,0,3,3
512,PH041016000,ketsana,2009,10,1,11
513,PH041017000,ketsana,2009,1,0,1
514,PH041018000,ketsana,2009,3,414,417
515,PH041019000,ketsana,2009,168,671,839
516,PH041020000,ketsana,2009,0,1,1
517,PH041021000,ketsana,2009,1,0,1
518,PH041023000,ketsana,2009,0,31,31
519,PH041024000,ketsana,2009,0,2,2
520,PH041025000,ketsana,2009,1,127,128
521,PH041027000,ketsana,2009,1,25,26
522,PH041030000,ketsana,2009,2,75,77
523,PH041031000,ketsana,2009,13,33,46
524,PH041034000,ketsana,2009,0,1,1
525,PH043401000,ketsana,2009,1,9,10
526,PH043402000,ketsana,2009,311,563,874
527,PH043403000,ketsana,2009,302,442,744
528,PH043405000,ketsana,2009,847,510,1357
529,PH043406000,ketsana,2009,0,17,17
530,PH043408000,ketsana,2009,55,96,151
531,PH043410000,ketsana,2009,0,5,5
532,PH043411000,ketsana,2009,324,249,573
533,PH043413000,ketsana,2009,46,84,130
534,PH043414000,ketsana,2009,51,98,149
535,PH043418000,ketsana,2009,2,2,4
536,PH043420000,ketsana,2009,7,98,105
537,PH043421000,ketsana,2009,12,23,35
538,PH043425000,ketsana,2009,12,15,27
539,PH043429000,ketsana,2009,109,220,329
540,PH043427000,ketsana,2009,168,1622,1790
541,PH043426000,ketsana,2009,44,55,99
542,PH043428000,ketsana,2009,1120,54,1174
543,PH043430000,ketsana,2009,136,0,136
544,PH042123000,ketsana,2009,19,42,61
545,PH042103000,ketsana,2009,9,5,14
546,PH042105000,ketsana,2009,1,1,2
547,PH042106000,ketsana,2009,4,904,908
548,PH042107000,ketsana,2009,2,0,2
549,PH042108000,ketsana,2009,30,9,39
550,PH042110000,ketsana,2009,0,57,57
551,PH042113000,ketsana,2009,30,114,144
552,PH042115000,ketsana,2009,45,832,877
553,PH042116000,ketsana,2009,12,0,12
554,PH013313000,ketsana,2009,9,0,9
555,PH042118000,ketsana,2009,4,0,4
556,PH042121000,ketsana,2009,61,114,175
557,PH045802000,ketsana,2009,133,0,133
558,PH045803000,ketsana,2009,265,117,382
559,PH045804000,ketsana,2009,980,1283,2263
560,PH045805000,ketsana,2009,0,49942,49942
561,PH045806000,ketsana,2009,524,181,705
562,PH045807000,ketsana,2009,4139,8155,12294
563,PH045810000,ketsana,2009,0,300,300
564,PH045808000,ketsana,2009,239,40,279
565,PH045811000,ketsana,2009,2493,3818,6311
566,PH045812000,ketsana,2009,610,804,1414
567,PH045813000,ketsana,2009,59,64,123
568,PH045814000,ketsana,2009,232,3935,4167
569,PH045617000,ketsana,2009,30,22,52
570,PH045622000,ketsana,2009,1,0,1
571,PH045641000,ketsana,2009,1,1,2
572,PH051731000,ketsana,2009,0,1,1
573,PH184514000,ketsana,2009,0,0,0
574,PH184530000,ketsana,2009,3,127,130
575,PH184527000,ketsana,2009,2,4,6
576,PH184511000,ketsana,2009,1,1,2
577,PH184512000,ketsana,2009,5,12,17
578,PH097332000,ketsana,2009,10,45,55
579,PH126505000,ketsana,2009,21,34,55
580,PH126509000,ketsana,2009,13,41,54
581,PH126312000,ketsana,2009,3,0,3
582,PH137501000,ketsana,2009,1684,13150,14834
583,PH137601000,ketsana,2009,3,3,6
584,PH137602000,ketsana,2009,317,11000,11317
585,PH137502000,ketsana,2009,159,0,159
586,PH137401000,ketsana,2009,1,1,2
587,PH137402000,ketsana,2009,1355,6783,8138
588,PH137603000,ketsana,2009,3839,42,3881
589,PH137503000,ketsana,2009,6748,85,6833
590,PH137604000,ketsana,2009,8,12,20
591,PH137403000,ketsana,2009,499,43030,43529
592,PH137404000,ketsana,2009,140,2968,3108
593,PH137607000,ketsana,2009,48,70,118
594,PH137504000,ketsana,2009,35,0,35
595,PH030803000,conson,2010,1,2,3
596,PH030807000,conson,2010,0,28,28
597,PH030808000,conson,2010,28,81,109
598,PH030812000,conson,2010,10,9,19
599,PH030806000,conson,2010,1,0,1
600,PH037107000,conson,2010,0,1,1
601,PH045801000,conson,2010,110,1538,1648
602,PH045803000,conson,2010,48,978,1026
603,PH045804000,conson,2010,44,493,537
604,PH045806000,conson,2010,62,713,775
605,PH045807000,conson,2010,20,832,852
606,PH045808999,conson,2010,0,250,250
607,PH045810000,conson,2010,751,1128,1879
608,PH045808000,conson,2010,1,1,2
609,PH045812000,conson,2010,96,338,434
610,PH045813000,conson,2010,81,838,919
611,PH045814000,conson,2010,123,1167,1290
612,PH042101000,conson,2010,0,2,2
613,PH042103000,conson,2010,106,3713,3819
614,PH042104000,conson,2010,12,219,231
615,PH042105000,conson,2010,54,331,385
616,PH042106000,conson,2010,30,391,421
617,PH042107000,conson,2010,2,54,56
618,PH042108000,conson,2010,132,859,991
619,PH042123000,conson,2010,49,498,547
620,PH042109000,conson,2010,10,387,397
621,PH042110000,conson,2010,0,6,6
622,PH042113000,conson,2010,18,734,752
623,PH042114000,conson,2010,0,1,1
624,PH042115000,conson,2010,58,0,58
625,PH042116000,conson,2010,135,564,699
626,PH042116999,conson,2010,4,258,262
627,PH042118000,conson,2010,2,145,147
628,PH042119000,conson,2010,11,147,158
629,PH042120000,conson,2010,96,175,271
630,PH042121000,conson,2010,170,2351,2521
631,PH042122000,conson,2010,7,0,7
632,PH045602000,conson,2010,1,0,1
633,PH045607000,conson,2010,0,350,350
634,PH045619999,conson,2010,59,44,103
635,PH045624000,conson,2010,13,169,182
636,PH045627000,conson,2010,0,52,52
637,PH045633000,conson,2010,1,7,8
638,PH045638000,conson,2010,33,182,215
639,PH045640999,conson,2010,1,2,3
640,PH045645000,conson,2010,6,301,307
641,PH045646000,conson,2010,4,20,24
642,PH041001000,conson,2010,3,6,9
643,PH041003000,conson,2010,3,33,36
644,PH041004000,conson,2010,1,52,53
645,PH041007000,conson,2010,8,13,21
646,PH041008000,conson,2010,0,1,1
647,PH041011000,conson,2010,1,15,16
648,PH041012000,conson,2010,7,29,36
649,PH041013000,conson,2010,16,509,525
650,PH041017000,conson,2010,1,2,3
651,PH041019000,conson,2010,42,323,365
652,PH041024999,conson,2010,0,21,21
653,PH041026999,conson,2010,0,2,2
654,PH041030000,conson,2010,9,23,32
655,PH041034000,conson,2010,3,47,50
656,PH043401000,conson,2010,0,87,87
657,PH043402000,conson,2010,46,213,259
658,PH043405000,conson,2010,215,407,622
659,PH043406000,conson,2010,2,0,2
660,PH043407000,conson,2010,32,44,76
661,PH043408000,conson,2010,20,80,100
662,PH043409000,conson,2010,10,9,19
663,PH043410000,conson,2010,0,75,75
664,PH043412000,conson,2010,0,93,93
665,PH043413000,conson,2010,30,100,130
666,PH043414000,conson,2010,100,300,400
667,PH043415000,conson,2010,0,10,10
668,PH043417000,conson,2010,2,13,15
669,PH043419000,conson,2010,10,81,91
670,PH043420000,conson,2010,31,205,236
671,PH043421000,conson,2010,74,346,420
672,PH043422000,conson,2010,31,276,307
673,PH043422999,conson,2010,4,100,104
674,PH043424000,conson,2010,7,1,8
675,PH043429000,conson,2010,333,809,1142
676,PH043428000,conson,2010,0,75,75
677,PH043426000,conson,2010,46,221,267
678,PH043426999,conson,2010,21,89,110
679,PH043429999,conson,2010,40,474,514
680,PH051735000,conson,2010,1,119,120
681,PH051605000,conson,2010,30,822,852
682,PH051606000,conson,2010,3,79,82
683,PH051608000,conson,2010,7,75,82
684,PH051604000,conson,2010,26,169,195
685,PH051610999,conson,2010,2,154,156
686,PH051611999,conson,2010,60,608,668
687,PH052006000,conson,2010,24,282,306
688,PH013301000,Nesat,2011,0,2,2
689,PH013302000,Nesat,2011,10,483,493
690,PH013303000,Nesat,2011,1,0,1
691,PH013305000,Nesat,2011,0,1,1
692,PH013308000,Nesat,2011,5,275,280
693,PH013313000,Nesat,2011,4,357,361
694,PH013317000,Nesat,2011,0,10,10
695,PH015511000,Nesat,2011,1,0,1
696,PH015507000,Nesat,2011,0,3,3
697,PH015514000,Nesat,2011,38,3047,3085
698,PH015516000,Nesat,2011,5,265,270
699,PH015518000,Nesat,2011,10,0,10
700,PH015520000,Nesat,2011,21,6,27
701,PH015522000,Nesat,2011,0,5,5
702,PH015523000,Nesat,2011,0,14,14
703,PH015527000,Nesat,2011,3,11,14
704,PH015528000,Nesat,2011,0,5,5
705,PH015541000,Nesat,2011,2,3,5
706,PH015546000,Nesat,2011,2,12,14
707,PH015547000,Nesat,2011,0,2,2
708,PH012809000,Nesat,2011,8,0,8
709,PH012814000,Nesat,2011,1,0,1
710,PH023102000,Nesat,2011,28,8,36
711,PH023104000,Nesat,2011,0,155,155
712,PH023107000,Nesat,2011,0,11,11
713,PH023108000,Nesat,2011,0,19,19
714,PH023109000,Nesat,2011,152,1260,1412
715,PH023110000,Nesat,2011,0,58,58
716,PH023112000,Nesat,2011,522,1024,1546
717,PH023113000,Nesat,2011,1,0,1
718,PH023114000,Nesat,2011,57,129,186
719,PH023115000,Nesat,2011,84,420,504
720,PH023124000,Nesat,2011,32,159,191
721,PH023125000,Nesat,2011,2,27,29
722,PH023127000,Nesat,2011,0,1750,1750
723,PH023128000,Nesat,2011,52,190,242
724,PH023129000,Nesat,2011,22,165,187
725,PH023131000,Nesat,2011,1,10,11
726,PH023132000,Nesat,2011,46,0,46
727,PH023135000,Nesat,2011,464,4989,5453
728,PH023134000,Nesat,2011,5,0,5
729,PH025015000,Nesat,2011,0,89,89
730,PH025001000,Nesat,2011,9,21,30
731,PH025002000,Nesat,2011,0,0,0
732,PH025003000,Nesat,2011,31,87,118
733,PH025004000,Nesat,2011,2,0,2
734,PH025005000,Nesat,2011,47,333,380
735,PH025006000,Nesat,2011,22,31,53
736,PH025007000,Nesat,2011,1,18,19
737,PH025008000,Nesat,2011,3,35,38
738,PH025009000,Nesat,2011,10,22,32
739,PH025011000,Nesat,2011,17,55,72
740,PH025013000,Nesat,2011,10,262,272
741,PH025012000,Nesat,2011,1,5,6
742,PH025701000,Nesat,2011,760,2040,2800
743,PH025702000,Nesat,2011,106,895,1001
744,PH025703000,Nesat,2011,464,2444,2908
745,PH025704000,Nesat,2011,181,1731,1912
746,PH025706000,Nesat,2011,45,271,316
747,PH025705000,Nesat,2011,118,1111,1229
748,PH037701000,Nesat,2011,5,18,23
749,PH037702000,Nesat,2011,161,2726,2887
750,PH037703000,Nesat,2011,85,1172,1257
751,PH037704000,Nesat,2011,236,472,708
752,PH037705000,Nesat,2011,8,0,8
753,PH037706000,Nesat,2011,19,958,977
754,PH037707000,Nesat,2011,21,336,357
755,PH037708000,Nesat,2011,10,61,71
756,PH034903000,Nesat,2011,205,454,659
757,PH034907000,Nesat,2011,9,5,14
758,PH034910000,Nesat,2011,8,427,435
759,PH034909000,Nesat,2011,26,230,256
760,PH034914000,Nesat,2011,0,43,43
761,PH034919000,Nesat,2011,23,49,72
762,PH034923000,Nesat,2011,0,15,15
763,PH034926000,Nesat,2011,8,9,17
764,PH034928000,Nesat,2011,62,448,510
765,PH034929000,Nesat,2011,2,8,10
766,PH034930000,Nesat,2011,18,81,99
767,PH037101000,Nesat,2011,4,61,65
768,PH037102000,Nesat,2011,130,335,465
769,PH037103000,Nesat,2011,137,528,665
770,PH037104000,Nesat,2011,1,102,103
771,PH037105000,Nesat,2011,73,220,293
772,PH037106000,Nesat,2011,81,811,892
773,PH037107000,Nesat,2011,2,0,2
774,PH037108000,Nesat,2011,86,343,429
775,PH037109000,Nesat,2011,61,564,625
776,PH037110000,Nesat,2011,14,36,50
777,PH037111000,Nesat,2011,19,25,44
778,PH037112000,Nesat,2011,31,259,290
779,PH037113000,Nesat,2011,169,1340,1509
780,PH037114000,Nesat,2011,436,749,1185
781,PH030801000,Nesat,2011,10,774,784
782,PH030803000,Nesat,2011,18,122,140
783,PH030804000,Nesat,2011,102,273,375
784,PH030805000,Nesat,2011,16,110,126
785,PH030806000,Nesat,2011,67,621,688
786,PH030810000,Nesat,2011,205,454,659
787,PH030812000,Nesat,2011,2,0,2
788,PH031401000,Nesat,2011,53,9,62
789,PH031402000,Nesat,2011,10,34,44
790,PH031403000,Nesat,2011,3,141,144
791,PH031404000,Nesat,2011,33,52,85
792,PH031405000,Nesat,2011,7,136,143
793,PH031406000,Nesat,2011,100,446,546
794,PH031424000,Nesat,2011,86,218,304
795,PH031408000,Nesat,2011,0,75,75
796,PH031409000,Nesat,2011,0,64,64
797,PH031410000,Nesat,2011,4,35,39
798,PH031412000,Nesat,2011,55,5,60
799,PH031414000,Nesat,2011,45,0,45
800,PH031416000,Nesat,2011,124,527,651
801,PH031417000,Nesat,2011,1,20,21
802,PH031418000,Nesat,2011,28,186,214
803,PH031419000,Nesat,2011,2,19,21
804,PH031420000,Nesat,2011,19,1,20
805,PH031421000,Nesat,2011,209,224,433
806,PH031422000,Nesat,2011,0,92,92
807,PH031423000,Nesat,2011,98,145,243
808,PH036903000,Nesat,2011,23,58,81
809,PH036911000,Nesat,2011,0,1,1
810,PH036913000,Nesat,2011,3,12,15
811,PH035401000,Nesat,2011,1,0,1
812,PH035402000,Nesat,2011,3,4,7
813,PH035406000,Nesat,2011,64,317,381
814,PH035408000,Nesat,2011,0,3,3
815,PH035410000,Nesat,2011,4,63,67
816,PH035411000,Nesat,2011,4,317,321
817,PH035409000,Nesat,2011,9,44,53
818,PH035412000,Nesat,2011,0,59,59
819,PH035413000,Nesat,2011,0,6,6
820,PH035415000,Nesat,2011,0,1,1
821,PH035422000,Nesat,2011,0,28,28
822,PH035416000,Nesat,2011,2,0,2
823,PH035417000,Nesat,2011,0,154,154
824,PH035418000,Nesat,2011,0,58,58
825,PH035420000,Nesat,2011,1,39,40
826,PH041001000,Nesat,2011,2,7,9
827,PH041007000,Nesat,2011,2,2,4
828,PH041009000,Nesat,2011,0,2,2
829,PH041013000,Nesat,2011,1,61,62
830,PH041019000,Nesat,2011,0,7,7
831,PH041020000,Nesat,2011,0,1,1
832,PH041027000,Nesat,2011,3,0,3
833,PH041029000,Nesat,2011,1,1,2
834,PH042105000,Nesat,2011,56,3,59
835,PH042123000,Nesat,2011,6,8,14
836,PH042113000,Nesat,2011,13,270,283
837,PH042119000,Nesat,2011,5,0,5
838,PH043402000,Nesat,2011,0,3,3
839,PH045801000,Nesat,2011,0,2,2
840,PH045813000,Nesat,2011,2,10,12
841,PH175904000,Nesat,2011,1,0,1
842,PH175911000,Nesat,2011,0,5,5
843,PH175101000,Nesat,2011,2,1,3
844,PH175104000,Nesat,2011,1,0,1
845,PH050501000,Nesat,2011,0,8,8
846,PH051711000,Nesat,2011,12,42,54
847,PH056212000,Nesat,2011,1,10,11
848,PH056214000,Nesat,2011,1,5,6
849,PH051735000,Nesat,2011,5,786,791
850,PH184521000,Nesat,2011,1,4,5
851,PH184513000,Nesat,2011,1,0,1
852,PH063030000,Nesat,2011,5,43,48
853,PH063022000,Nesat,2011,7,21,28
854,PH060601000,Nesat,2011,1,0,1
855,PH143201000,Nesat,2011,5,59,64
856,PH143206000,Nesat,2011,1,89,90
857,PH143209000,Nesat,2011,0,2,2
858,PH143208000,Nesat,2011,1,55,56
859,PH143214000,Nesat,2011,0,7,7
860,PH143215000,Nesat,2011,1,110,111
861,PH141104000,Nesat,2011,1,1,2
862,PH141105000,Nesat,2011,5,0,5
863,PH141106000,Nesat,2011,3,2,5
864,PH141107000,Nesat,2011,2,2,4
865,PH141108000,Nesat,2011,0,1,1
866,PH141109000,Nesat,2011,1,16,17
867,PH141112000,Nesat,2011,1,3,4
868,PH141113000,Nesat,2011,0,11,11
869,PH141114000,Nesat,2011,1,0,1
870,PH140103000,Nesat,2011,1,0,1
871,PH140108000,Nesat,2011,0,1,1
872,PH140109000,Nesat,2011,0,24,24
873,PH140120000,Nesat,2011,1,0,1
874,PH140122000,Nesat,2011,0,9,9
875,PH140125000,Nesat,2011,0,1,1
876,PH144404000,Nesat,2011,0,1,1
877,PH144405000,Nesat,2011,3,108,111
878,PH144406000,Nesat,2011,0,1,1
879,PH144410000,Nesat,2011,0,1,1
880,PH142707000,Nesat,2011,9,29,38
881,PH142711000,Nesat,2011,17,153,170
882,PH142701000,Nesat,2011,26,448,474
883,PH142709000,Nesat,2011,6,77,83
884,PH142702000,Nesat,2011,1,15,16
885,PH142703000,Nesat,2011,15,84,99
886,PH142704000,Nesat,2011,5,59,64
887,PH142705000,Nesat,2011,11,292,303
888,PH148103000,Nesat,2011,0,5,5
889,PH148104000,Nesat,2011,0,5,5
890,PH013306000,Bopha,2012,1,1,2
891,PH071201000,Bopha,2012,1,4,5
892,PH071209000,Bopha,2012,10,59,69
893,PH071220000,Bopha,2012,1,1,2
894,PH071221000,Bopha,2012,1,2,3
895,PH071226000,Bopha,2012,10,1,11
896,PH071228000,Bopha,2012,1,15,16
897,PH071230000,Bopha,2012,1,2,3
898,PH071243000,Bopha,2012,1,2,3
899,PH072202000,Bopha,2012,17,22,39
900,PH072203000,Bopha,2012,44,99,143
901,PH072205000,Bopha,2012,1,4,5
902,PH072207000,Bopha,2012,14,16,30
903,PH072212000,Bopha,2012,21,78,99
904,PH072222000,Bopha,2012,35,460,495
905,PH072225000,Bopha,2012,56,175,231
906,PH072229000,Bopha,2012,23,170,193
907,PH072235000,Bopha,2012,54,268,322
908,PH072240000,Bopha,2012,92,344,436
909,PH072241000,Bopha,2012,1,1,2
910,PH072245000,Bopha,2012,65,513,578
911,PH072246000,Bopha,2012,1,39,40
912,PH076101000,Bopha,2012,2,314,316
913,PH076102000,Bopha,2012,38,322,360
914,PH076103000,Bopha,2012,100,687,787
915,PH076104000,Bopha,2012,66,875,941
916,PH076105000,Bopha,2012,46,427,473
917,PH076106000,Bopha,2012,51,748,799
918,PH101301000,Bopha,2012,46,801,847
919,PH101303000,Bopha,2012,1,3,4
920,PH101305000,Bopha,2012,121,557,678
921,PH101310000,Bopha,2012,3,15,18
922,PH101311000,Bopha,2012,23,191,214
923,PH101313000,Bopha,2012,257,1558,1815
924,PH101314000,Bopha,2012,30,135,165
925,PH101318000,Bopha,2012,140,215,355
926,PH101319000,Bopha,2012,26,158,184
927,PH101320000,Bopha,2012,12,40,52
928,PH101321000,Bopha,2012,301,1100,1401
929,PH101322000,Bopha,2012,54,37,91
930,PH101801000,Bopha,2012,5,64,69
931,PH101802000,Bopha,2012,1,14,15
932,PH101803000,Bopha,2012,1,5,6
933,PH101804000,Bopha,2012,3,4,7
934,PH101805000,Bopha,2012,12,79,91
935,PH103501000,Bopha,2012,9,87,96
936,PH103504000,Bopha,2012,82,1285,1367
937,PH103505000,Bopha,2012,3,15,18
938,PH103507000,Bopha,2012,1,2,3
939,PH103508000,Bopha,2012,1,11,12
940,PH103509000,Bopha,2012,7,11,18
941,PH103516000,Bopha,2012,37,214,251
942,PH103518000,Bopha,2012,3,6,9
943,PH103519000,Bopha,2012,27,67,94
944,PH103520000,Bopha,2012,1,50,51
945,PH103522000,Bopha,2012,1,20,21
946,PH104201000,Bopha,2012,6,1,7
947,PH104202000,Bopha,2012,6,1,7
948,PH104205000,Bopha,2012,34,11,45
949,PH104207000,Bopha,2012,1,3,4
950,PH104208000,Bopha,2012,1,3,4
951,PH104209000,Bopha,2012,12,12,24
952,PH104210000,Bopha,2012,23,78,101
953,PH104211000,Bopha,2012,1,1,2
954,PH104216000,Bopha,2012,10,20,30
955,PH104301000,Bopha,2012,5,43,48
956,PH104303000,Bopha,2012,1,6,7
957,PH104304000,Bopha,2012,11,71,82
958,PH104305000,Bopha,2012,29,114,143
959,PH104306000,Bopha,2012,1,70,71
960,PH104307000,Bopha,2012,7,20,27
961,PH104308000,Bopha,2012,239,2168,2407
962,PH104309000,Bopha,2012,8,4,12
963,PH104312000,Bopha,2012,4,14,18
964,PH104314000,Bopha,2012,1,33,34
965,PH104315000,Bopha,2012,3,55,58
966,PH104316000,Bopha,2012,15,60,75
967,PH104317000,Bopha,2012,56,370,426
968,PH104318000,Bopha,2012,1,20,21
969,PH104321000,Bopha,2012,2,200,202
970,PH104322000,Bopha,2012,66,291,357
971,PH104323000,Bopha,2012,4,100,104
972,PH104324000,Bopha,2012,3,119,122
973,PH104325000,Bopha,2012,3,287,290
974,PH104326000,Bopha,2012,1,33,34
975,PH112301000,Bopha,2012,1,790,791
976,PH112303000,Bopha,2012,15,5,20
977,PH112305000,Bopha,2012,1,1069,1070
978,PH112314000,Bopha,2012,87,754,841
979,PH112324000,Bopha,2012,125,244,369
980,PH112501000,Bopha,2012,6900,1,6901
981,PH112503000,Bopha,2012,2980,1418,4398
982,PH112504000,Bopha,2012,2017,3591,5608
983,PH112505000,Bopha,2012,9729,271,10000
984,PH112508000,Bopha,2012,80,1500,1580
985,PH112509000,Bopha,2012,77,136,213
986,PH112511000,Bopha,2012,192,1354,1546
987,PH118201000,Bopha,2012,9059,9649,18708
988,PH118202000,Bopha,2012,5815,8711,14526
989,PH118203000,Bopha,2012,57,1527,1584
990,PH118204000,Bopha,2012,274,1589,1863
991,PH118205000,Bopha,2012,147,1000,1147
992,PH118206000,Bopha,2012,710,3299,4009
993,PH118207000,Bopha,2012,6777,13355,20132
994,PH118208000,Bopha,2012,5423,5495,10918
995,PH118209000,Bopha,2012,2633,6416,9049
996,PH118210000,Bopha,2012,7702,4824,12526
997,PH118211000,Bopha,2012,56,536,592
998,PH126317000,Bopha,2012,3,3,6
999,PH126318000,Bopha,2012,1,7,8
1000,PH153601000,Bopha,2012,7,2,9
1001,PH153603000,Bopha,2012,5,16,21
1002,PH153606000,Bopha,2012,15,31,46
1003,PH153610000,Bopha,2012,7,18,25
1004,PH153611000,Bopha,2012,1,2,3
1005,PH153615000,Bopha,2012,147,47,194
1006,PH153622000,Bopha,2012,3,14,17
1007,PH153623000,Bopha,2012,1,2,3
1008,PH153624000,Bopha,2012,5,25,30
1009,PH153626000,Bopha,2012,1,8,9
1010,PH153627000,Bopha,2012,4,13,17
1011,PH153631000,Bopha,2012,30,1,31
1012,PH153632000,Bopha,2012,1,9,10
1013,PH153633000,Bopha,2012,10,15,25
1014,PH153635000,Bopha,2012,16,142,158
1015,PH153639000,Bopha,2012,6,24,30
1016,PH160201000,Bopha,2012,1,43,44
1017,PH160202000,Bopha,2012,12,254,266
1018,PH160204000,Bopha,2012,21,127,148
1019,PH160206000,Bopha,2012,3,10,13
1020,PH160207000,Bopha,2012,2,58,60
1021,PH160211000,Bopha,2012,2,1,3
1022,PH160302000,Bopha,2012,1770,1643,3413
1023,PH160303000,Bopha,2012,3,9,12
1024,PH160304000,Bopha,2012,559,2395,2954
1025,PH160305000,Bopha,2012,5014,3269,8283
1026,PH160306000,Bopha,2012,6,631,637
1027,PH160307000,Bopha,2012,193,1796,1989
1028,PH160308000,Bopha,2012,4,208,212
1029,PH160309000,Bopha,2012,9,1,10
1030,PH160310000,Bopha,2012,1697,2411,4108
1031,PH160311000,Bopha,2012,248,173,421
1032,PH160312000,Bopha,2012,5606,2331,7937
1033,PH160313000,Bopha,2012,3245,4371,7616
1034,PH160313000,Bopha,2012,220,1,221
1035,PH160314000,Bopha,2012,1,53,54
1036,PH166702000,Bopha,2012,1,2,3
1037,PH166706000,Bopha,2012,1,33,34
1038,PH166707000,Bopha,2012,6,6,12
1039,PH166714000,Bopha,2012,1,1,2
1040,PH166716000,Bopha,2012,1,547,548
1041,PH166717000,Bopha,2012,10,21,31
1042,PH166720000,Bopha,2012,1,280,281
1043,PH166721000,Bopha,2012,1,51,52
1044,PH166724000,Bopha,2012,1,3,4
1045,PH166801000,Bopha,2012,42,29,71
1046,PH166802000,Bopha,2012,3,200,203
1047,PH166803000,Bopha,2012,575,9105,9680
1048,PH166804000,Bopha,2012,17,1,18
1049,PH166806000,Bopha,2012,1,1,2
1050,PH166808000,Bopha,2012,16,1164,1180
1051,PH166809000,Bopha,2012,223,2800,3023
1052,PH166810000,Bopha,2012,1,10,11
1053,PH166811000,Bopha,2012,25,21,46
1054,PH166812000,Bopha,2012,3652,3694,7346
1055,PH166814000,Bopha,2012,25,65,90
1056,PH166815000,Bopha,2012,5,56,61
1057,PH166817000,Bopha,2012,1350,616,1966
1058,PH166819000,Bopha,2012,3,15,18
1059,PH168502000,Bopha,2012,1,1,2
1060,PH168503000,Bopha,2012,1,5,6
1061,PH175303000,Bopha,2012,12,202,214
1062,PH175308000,Bopha,2012,12,188,200
1063,PH175311000,Bopha,2012,3,1,4
1064,PH175320000,Bopha,2012,848,34,882
1065,PH012904000,Trami,2013,2,0,2
1066,PH012928000,Trami,2013,1,0,1
1067,PH012927000,Trami,2013,0,0,0
1068,PH015533000,Trami,2013,4,0,4
1069,PH015546000,Trami,2013,0,0,0
1070,PH015527000,Trami,2013,1,0,1
1071,PH031416000,Trami,2013,0,0,0
1072,PH031414000,Trami,2013,1,0,1
1073,PH031410000,Trami,2013,0,0,0
1074,PH031420000,Trami,2013,3,0,3
1075,PH030812000,Trami,2013,6,0,6
1076,PH030802000,Trami,2013,0,0,0
1077,PH030806000,Trami,2013,3,0,3
1078,PH030808000,Trami,2013,0,0,0
1079,PH036903000,Trami,2013,1,0,1
1080,PH035406000,Trami,2013,23,0,23
1081,PH035416000,Trami,2013,3,0,3
1082,PH035401000,Trami,2013,153,0,153
1083,PH035411000,Trami,2013,2,0,2
1084,PH037104000,Trami,2013,0,0,0
1085,PH041008000,Trami,2013,1,0,1
1086,PH041019000,Trami,2013,4,0,4
1087,PH041007000,Trami,2013,0,0,0
1088,PH041013000,Trami,2013,0,0,0
1089,PH042108000,Trami,2013,179,0,179
1090,PH042122000,Trami,2013,5,0,5
1091,PH042104000,Trami,2013,3,0,3
1092,PH042120000,Trami,2013,91,0,91
1093,PH042109000,Trami,2013,124,0,124
1094,PH045808000,Trami,2013,6,0,6
1095,PH045801000,Trami,2013,12,0,12
1096,PH045805000,Trami,2013,0,0,0
1097,PH045802000,Trami,2013,16,0,16
1098,PH045809000,Trami,2013,0,0,0
1099,PH045807000,Trami,2013,0,0,0
1100,PH045810000,Trami,2013,7,0,7
1101,PH045645000,Trami,2013,1,0,1
1102,PH148101000,Usagi,2013,1,437,438
1103,PH012815000,Usagi,2013,1,250,251
1104,PH012805000,Usagi,2013,1,4,5
1105,PH020901000,Usagi,2013,151,0,151
1106,PH020902000,Usagi,2013,10,0,10
1107,PH020903000,Usagi,2013,5,0,5
1108,PH020904000,Usagi,2013,8,0,8
1109,PH021505000,Usagi,2013,25,0,25
1110,PH021509000,Usagi,2013,340,0,340
1111,PH175101000,Usagi,2013,14,0,14
1112,PH175107000,Usagi,2013,4,0,4
1113,PH052004000,Usagi,2013,16,0,16
1114,PH184502000,Usagi,2013,6,0,6
1115,PH063034000,Usagi,2013,1,0,1
1116,PH060613000,Usagi,2013,1,0,1
1117,PH060602000,Usagi,2013,2,0,2
1118,PH015527000,Nari,2013,1,29,30
1119,PH025001000,Nari,2013,0,1,1
1120,PH025015000,Nari,2013,3,72,75
1121,PH037701000,Nari,2013,12,57,69
1122,PH037705000,Nari,2013,8,196,204
1123,PH037706000,Nari,2013,8,189,197
1124,PH037707000,Nari,2013,11,163,174
1125,PH037707999,Nari,2013,103,466,569
1126,PH031421000,Nari,2013,858,1670,2528
1127,PH031416000,Nari,2013,0,13,13
1128,PH031422000,Nari,2013,0,2,2
1129,PH035405000,Nari,2013,3,438,441
1130,PH037112999,Nari,2013,4,1,5
1131,PH037110000,Nari,2013,40,290,330
1132,PH034921999,Nari,2013,10,1,11
1133,PH034922999,Nari,2013,36,664,700
1134,PH034912000,Nari,2013,2102,4634,6736
1135,PH034927000,Nari,2013,1027,3498,4525
1136,PH034924999,Nari,2013,961,2600,3561
1137,PH034921000,Nari,2013,132,1103,1235
1138,PH034904000,Nari,2013,15,156,171
1139,PH034932000,Nari,2013,1864,6305,8169
1140,PH034909000,Nari,2013,208,164,372
1141,PH034928000,Nari,2013,637,2270,2907
1142,PH034924000,Nari,2013,98,636,734
1143,PH034908000,Nari,2013,143,206,349
1144,PH034930000,Nari,2013,89,1981,2070
1145,PH034919000,Nari,2013,229,1639,1868
1146,PH034902000,Nari,2013,37,647,684
1147,PH034926000,Nari,2013,16,436,452
1148,PH034903000,Nari,2013,840,2029,2869
1149,PH036907000,Nari,2013,552,5044,5596
1150,PH036908000,Nari,2013,36,103,139
1151,PH036906000,Nari,2013,94,330,424
1152,PH036915000,Nari,2013,9,246,255
1153,PH036909000,Nari,2013,6,0,6
1154,PH036910000,Nari,2013,2,6,8
1155,PH036905000,Nari,2013,46,2188,2234
1156,PH036912000,Nari,2013,0,9,9
1157,PH036911000,Nari,2013,11,154,165
1158,PH036918000,Nari,2013,58,310,368
1159,PH036902000,Nari,2013,48,315,363
1160,PH036904000,Nari,2013,134,931,1065
1161,PH036916000,Nari,2013,0,357,357
1162,PH012809000,Krosa,2013,2,50,52
1163,PH012804000,Krosa,2013,1,5,6
1164,PH012821000,Krosa,2013,1,21,22
1165,PH012815000,Krosa,2013,1,190,191
1166,PH012817000,Krosa,2013,0,299,299
1167,PH012813000,Krosa,2013,5,45,50
1168,PH012810000,Krosa,2013,1,8,9
1169,PH012806000,Krosa,2013,0,100,100
1170,PH012819000,Krosa,2013,0,15,15
1171,PH012811000,Krosa,2013,3,2,5
1172,PH012802000,Krosa,2013,6,34,40
1173,PH012823000,Krosa,2013,0,4,4
1174,PH012803000,Krosa,2013,0,1,1
1175,PH012816000,Krosa,2013,0,31,31
1176,PH012808000,Krosa,2013,0,5,5
1177,PH012812000,Krosa,2013,16,240,256
1178,PH021514000,Krosa,2013,19,341,360
1179,PH021525000,Krosa,2013,23,98,121
1180,PH021505000,Krosa,2013,1378,9093,10471
1181,PH021510000,Krosa,2013,125,1483,1608
1182,PH021507000,Krosa,2013,292,1903,2195
1183,PH021517000,Krosa,2013,163,581,744
1184,PH021522000,Krosa,2013,166,1784,1950
1185,PH021524000,Krosa,2013,4,105,109
1186,PH021515000,Krosa,2013,35,630,665
1187,PH021513000,Krosa,2013,41,318,359
1188,PH021516000,Krosa,2013,402,3178,3580
1189,PH021508000,Krosa,2013,12,215,227
1190,PH021523000,Krosa,2013,169,2060,2229
1191,PH021503000,Krosa,2013,85,713,798
1192,PH021518000,Krosa,2013,50,100,150
1193,PH021526000,Krosa,2013,75,412,487
1194,PH021501000,Krosa,2013,145,2225,2370
1195,PH021504000,Krosa,2013,163,1448,1611
1196,PH021521000,Krosa,2013,0,238,238
1197,PH021511000,Krosa,2013,7,732,739
1198,PH021506000,Krosa,2013,83,799,882
1199,PH015504000,Krosa,2013,143,1622,1765
1200,PH148101000,Krosa,2013,0,2,2
1201,PH148103000,Krosa,2013,174,933,1107
1202,PH148104999,Krosa,2013,3,63,66
1203,PH148107000,Krosa,2013,87,1027,1114
1204,PH148102000,Krosa,2013,5,40,45
1205,PH148106000,Krosa,2013,12,433,445
1206,PH013301000,Utor,2013,1,1,2
1207,PH013312000,Utor,2013,1,1,2
1208,PH013314000,Utor,2013,1,1,2
1209,PH013320000,Utor,2013,1,1,2
1210,PH015523000,Utor,2013,6,3,9
1211,PH015529000,Utor,2013,2,13,15
1212,PH015536000,Utor,2013,1,1,2
1213,PH015543000,Utor,2013,1,1,2
1214,PH023109000,Utor,2013,1,53,54
1215,PH023112000,Utor,2013,4,1,5
1216,PH023115000,Utor,2013,1,16,17
1217,PH023127000,Utor,2013,5,119,124
1218,PH025001000,Utor,2013,1,19,20
1219,PH025002000,Utor,2013,6,154,160
1220,PH025003000,Utor,2013,4,64,68
1221,PH025004000,Utor,2013,8,32,40
1222,PH025005000,Utor,2013,8,33,41
1223,PH025006000,Utor,2013,11,54,65
1224,PH025007000,Utor,2013,1,10,11
1225,PH025008000,Utor,2013,1,10,11
1226,PH025009000,Utor,2013,36,107,143
1227,PH025011000,Utor,2013,1,79,80
1228,PH025012000,Utor,2013,1,104,105
1229,PH025013000,Utor,2013,4,75,79
1230,PH025014000,Utor,2013,1,22,23
1231,PH025015000,Utor,2013,1,9,10
1232,PH025701000,Utor,2013,102,1054,1156
1233,PH025702000,Utor,2013,87,1130,1217
1234,PH025703000,Utor,2013,8,318,326
1235,PH025704000,Utor,2013,271,3231,3502
1236,PH025705000,Utor,2013,10,416,426
1237,PH025706000,Utor,2013,110,1463,1573
1238,PH031421000,Utor,2013,1,1,2
1239,PH035405000,Utor,2013,3,6,9
1240,PH037106000,Utor,2013,3,1,4
1241,PH037113000,Utor,2013,19,348,367
1242,PH037702000,Utor,2013,1257,4026,5283
1243,PH037703000,Utor,2013,133,1941,2074
1244,PH037704000,Utor,2013,369,1635,2004
1245,PH037706000,Utor,2013,101,1706,1807
1246,PH037707000,Utor,2013,2,97,99
1247,PH037708000,Utor,2013,6,86,92
1248,PH056203000,Utor,2013,7,1,8
1249,PH142701000,Utor,2013,1,18,19
1250,PH142702000,Utor,2013,1,2,3
1251,PH142703000,Utor,2013,1,5,6
1252,PH142704000,Utor,2013,1,41,42
1253,PH142705000,Utor,2013,2,37,39
1254,PH142706000,Utor,2013,1,5,6
1255,PH142709000,Utor,2013,1,10,11
1256,PH142710000,Utor,2013,1,12,13
1257,PH142711000,Utor,2013,1,19,20
1258,PH143206000,Utor,2013,1,6,7
1259,PH144405000,Utor,2013,1,13,14
1260,PH051714000,Lingling,2014,12,437,449
1261,PH103504000,Lingling,2014,92,4,96
1262,PH103501000,Lingling,2014,7,0,7
1263,PH103505000,Lingling,2014,4,0,4
1264,PH103507000,Lingling,2014,151,0,151
1265,PH103510000,Lingling,2014,27,0,27
1266,PH104210000,Lingling,2014,5,0,5
1267,PH104308000,Lingling,2014,26,0,26
1268,PH103520000,Lingling,2014,14,0,14
1269,PH104305000,Lingling,2014,6,0,6
1270,PH101305000,Lingling,2014,3,0,3
1271,PH112511000,Lingling,2014,104,0,104
1272,PH112507000,Lingling,2014,67,0,67
1273,PH112503000,Lingling,2014,349,0,349
1274,PH112505000,Lingling,2014,293,0,293
1275,PH112508000,Lingling,2014,3,0,3
1276,PH112504000,Lingling,2014,59,0,59
1277,PH112506000,Lingling,2014,3,0,3
1278,PH112509000,Lingling,2014,30,0,30
1279,PH112501000,Lingling,2014,0,0,0
1280,PH118210000,Lingling,2014,21,0,21
1281,PH160202000,Lingling,2014,14,0,14
1282,PH160207000,Lingling,2014,33,0,33
1283,PH160206000,Lingling,2014,0,0,0
1284,PH160207999,Lingling,2014,3,0,3
1285,PH160205000,Lingling,2014,6,0,6
1286,PH160209000,Lingling,2014,6,0,6
1287,PH160203999,Lingling,2014,1,0,1
1288,PH160312000,Lingling,2014,30,0,30
1289,PH160302000,Lingling,2014,30,0,30
1290,PH160306000,Lingling,2014,1,0,1
1291,PH160301000,Lingling,2014,1,0,1
1292,PH160311000,Lingling,2014,3,0,3
1293,PH160314000,Lingling,2014,14,0,14
1294,PH166815000,Lingling,2014,6,0,6
1295,PH166812000,Lingling,2014,44,0,44
1296,PH166807000,Lingling,2014,7,0,7
1297,PH166803000,Lingling,2014,9,0,9
1298,PH166819000,Lingling,2014,15,0,15
1299,PH166810000,Lingling,2014,1,0,1
1300,PH166809000,Lingling,2014,3,0,3
1301,PH166816000,Lingling,2014,13,0,13
1302,PH166818000,Lingling,2014,27,0,27
1303,PH166806000,Lingling,2014,2,0,2
1304,PH166801000,Lingling,2014,8,0,8
1305,PH166804000,Lingling,2014,2,0,2
1306,PH166711000,Lingling,2014,13,0,13
1307,PH166722000,Lingling,2014,0,0,0
1308,PH166708000,Lingling,2014,0,0,0
1309,PH166710000,Lingling,2014,84,0,84
1310,PH166717000,Lingling,2014,39,0,39
1311,PH166721000,Lingling,2014,1,0,1
1312,PH166720000,Lingling,2014,11,0,11
1313,PH166707000,Lingling,2014,1,0,1
1314,PH133901000,Rammasun,2014,27,15,42
1315,PH133902000,Rammasun,2014,3,0,3
1316,PH012820000,Rammasun,2014,3,0,3
1317,PH012924000,Rammasun,2014,2,0,2
1318,PH045639000,Rammasun,2014,1,0,1
1319,PH133908000,Rammasun,2014,4,0,4
1320,PH133910000,Rammasun,2014,4,0,4
1321,PH133911000,Rammasun,2014,1,0,1
1322,PH133913000,Rammasun,2014,2,0,2
1323,PH012805000,Rammasun,2014,3,2,5
1324,PH030801000,Rammasun,2014,36,55,91
1325,PH030802000,Rammasun,2014,1,50,51
1326,PH030803000,Rammasun,2014,32,459,491
1327,PH030805000,Rammasun,2014,13,253,266
1328,PH030810000,Rammasun,2014,345,1009,1354
1329,PH030811000,Rammasun,2014,76,234,310
1330,PH030812000,Rammasun,2014,10,730,740
1331,PH031404000,Rammasun,2014,3,2,5
1332,PH031410000,Rammasun,2014,5,2,7
1333,PH031409000,Rammasun,2014,33,123,156
1334,PH035406000,Rammasun,2014,4,36,40
1335,PH035413000,Rammasun,2014,1,3,4
1336,PH035414000,Rammasun,2014,2,11,13
1337,PH036902000,Rammasun,2014,1,0,1
1338,PH037101000,Rammasun,2014,53,349,402
1339,PH037102000,Rammasun,2014,11,76,87
1340,PH037105000,Rammasun,2014,14,25,39
1341,PH037108000,Rammasun,2014,5,59,64
1342,PH037110000,Rammasun,2014,4,44,48
1343,PH037111000,Rammasun,2014,8,128,136
1344,PH037112000,Rammasun,2014,7,42,49
1345,PH037113000,Rammasun,2014,5,32,37
1346,PH037114000,Rammasun,2014,73,88,161
1347,PH041001000,Rammasun,2014,140,1535,1675
1348,PH041005000,Rammasun,2014,121,420,541
1349,PH041007000,Rammasun,2014,189,3231,3420
1350,PH041008000,Rammasun,2014,92,1150,1242
1351,PH041009000,Rammasun,2014,13,2289,2302
1352,PH041010000,Rammasun,2014,177,1355,1532
1353,PH041013000,Rammasun,2014,239,3050,3289
1354,PH041016000,Rammasun,2014,11,58,69
1355,PH041017000,Rammasun,2014,861,2201,3062
1356,PH041019000,Rammasun,2014,727,7736,8463
1357,PH041021000,Rammasun,2014,480,5946,6426
1358,PH041022000,Rammasun,2014,100,2423,2523
1359,PH041023000,Rammasun,2014,639,8201,8840
1360,PH041025000,Rammasun,2014,170,1398,1568
1361,PH041027000,Rammasun,2014,27,970,997
1362,PH041029000,Rammasun,2014,197,1414,1611
1363,PH041032000,Rammasun,2014,110,739,849
1364,PH041033000,Rammasun,2014,39,256,295
1365,PH041034000,Rammasun,2014,26,380,406
1366,PH041004000,Rammasun,2014,175,2081,2256
1367,PH041018000,Rammasun,2014,103,1707,1810
1368,PH041002000,Rammasun,2014,86,1201,1287
1369,PH041014000,Rammasun,2014,505,17635,18140
1370,PH043401000,Rammasun,2014,120,80,200
1371,PH043402000,Rammasun,2014,1667,0,1667
1372,PH043405000,Rammasun,2014,567,2492,3059
1373,PH043406000,Rammasun,2014,369,3040,3409
1374,PH043408000,Rammasun,2014,17,423,440
1375,PH043410000,Rammasun,2014,158,939,1097
1376,PH043412000,Rammasun,2014,351,1876,2227
1377,PH043414000,Rammasun,2014,16,162,178
1378,PH043415000,Rammasun,2014,315,1510,1825
1379,PH043416000,Rammasun,2014,371,1358,1729
1380,PH043417000,Rammasun,2014,440,522,962
1381,PH043418000,Rammasun,2014,13,313,326
1382,PH043419000,Rammasun,2014,265,1671,1936
1383,PH043420000,Rammasun,2014,225,1054,1279
1384,PH043422000,Rammasun,2014,40,62,102
1385,PH021521000,Rammasun,2014,440,2270,2710
1386,PH043429000,Rammasun,2014,200,150,350
1387,PH043426000,Rammasun,2014,684,4578,5262
1388,PH043427000,Rammasun,2014,36,259,295
1389,PH043430000,Rammasun,2014,75,385,460
1390,PH043403000,Rammasun,2014,468,1908,2376
1391,PH043425000,Rammasun,2014,82,507,589
1392,PH043428000,Rammasun,2014,1023,2927,3950
1393,PH043411000,Rammasun,2014,767,4371,5138
1394,PH043424000,Rammasun,2014,4758,15131,19889
1395,PH043407000,Rammasun,2014,125,1480,1605
1396,PH042103000,Rammasun,2014,586,9188,9774
1397,PH042104000,Rammasun,2014,74,792,866
1398,PH042105000,Rammasun,2014,583,4753,5336
1399,PH042106000,Rammasun,2014,65,1552,1617
1400,PH042110000,Rammasun,2014,1260,2917,4177
1401,PH042111000,Rammasun,2014,40,1870,1910
1402,PH042113000,Rammasun,2014,10,453,463
1403,PH042115000,Rammasun,2014,20,884,904
1404,PH042116000,Rammasun,2014,35,547,582
1405,PH042117000,Rammasun,2014,74,0,74
1406,PH042118000,Rammasun,2014,134,718,852
1407,PH042119000,Rammasun,2014,272,4398,4670
1408,PH042120000,Rammasun,2014,114,2816,2930
1409,PH042121000,Rammasun,2014,2226,644,2870
1410,PH042122000,Rammasun,2014,293,2192,2485
1411,PH042123000,Rammasun,2014,74,765,839
1412,PH042108000,Rammasun,2014,137,950,1087
1413,PH042101000,Rammasun,2014,153,682,835
1414,PH045601000,Rammasun,2014,1322,1296,2618
1415,PH045602000,Rammasun,2014,142,1783,1925
1416,PH045603000,Rammasun,2014,1388,4504,5892
1417,PH045605000,Rammasun,2014,657,2751,3408
1418,PH045607000,Rammasun,2014,1249,5814,7063
1419,PH045608000,Rammasun,2014,563,8190,8753
1420,PH045615000,Rammasun,2014,591,3374,3965
1421,PH045616000,Rammasun,2014,500,700,1200
1422,PH045618000,Rammasun,2014,1083,4052,5135
1423,PH045619000,Rammasun,2014,1388,2328,3716
1424,PH045620000,Rammasun,2014,1,88,89
1425,PH045622000,Rammasun,2014,2866,9413,12279
1426,PH045624000,Rammasun,2014,3087,10598,13685
1427,PH045625000,Rammasun,2014,733,2042,2775
1428,PH045627000,Rammasun,2014,935,6388,7323
1429,PH045628000,Rammasun,2014,56,145,201
1430,PH045630000,Rammasun,2014,213,4735,4948
1431,PH045633000,Rammasun,2014,172,883,1055
1432,PH045634000,Rammasun,2014,1254,3669,4923
1433,PH045635000,Rammasun,2014,308,943,1251
1434,PH045637000,Rammasun,2014,189,1960,2149
1435,PH045638000,Rammasun,2014,61,1478,1539
1436,PH045639000,Rammasun,2014,59,892,951
1437,PH045640000,Rammasun,2014,82,2047,2129
1438,PH045641000,Rammasun,2014,631,2427,3058
1439,PH045642000,Rammasun,2014,47,264,311
1440,PH045646000,Rammasun,2014,781,4346,5127
1441,PH045649000,Rammasun,2014,1378,2818,4196
1442,PH045647000,Rammasun,2014,934,3959,4893
1443,PH045648000,Rammasun,2014,1781,10765,12546
1444,PH045610000,Rammasun,2014,1687,3500,5187
1445,PH045645000,Rammasun,2014,2242,9746,11988
1446,PH045645000,Rammasun,2014,8564,1805,10369
1447,PH045802000,Rammasun,2014,63,734,797
1448,PH045803000,Rammasun,2014,10,15,25
1449,PH045804000,Rammasun,2014,245,1022,1267
1450,PH045808000,Rammasun,2014,29,11,40
1451,PH045811000,Rammasun,2014,23,23,46
1452,PH045812000,Rammasun,2014,24,13,37
1453,PH045813000,Rammasun,2014,3,26,29
1454,PH045814000,Rammasun,2014,2,5,7
1455,PH045802000,Rammasun,2014,140,1316,1456
1456,PH045810000,Rammasun,2014,70,352,422
1457,PH174001000,Rammasun,2014,18,440,458
1458,PH174002000,Rammasun,2014,8,265,273
1459,PH174003000,Rammasun,2014,9,289,298
1460,PH174004000,Rammasun,2014,3,25,28
1461,PH174005000,Rammasun,2014,1,12,13
1462,PH175101000,Rammasun,2014,6,134,140
1463,PH175102000,Rammasun,2014,7,2120,2127
1464,PH175103000,Rammasun,2014,3,10,13
1465,PH175104000,Rammasun,2014,4,15,19
1466,PH175105000,Rammasun,2014,3,82,85
1467,PH175106000,Rammasun,2014,2,67,69
1468,PH175107000,Rammasun,2014,1,5,6
1469,PH021521000,Rammasun,2014,6,136,142
1470,PH175109000,Rammasun,2014,3,394,397
1471,PH175110000,Rammasun,2014,18,2501,2519
1472,PH175111000,Rammasun,2014,3,19,22
1473,PH175201000,Rammasun,2014,5,127,132
1474,PH175207000,Rammasun,2014,2,16,18
1475,PH175208000,Rammasun,2014,7,159,166
1476,PH175211000,Rammasun,2014,13,42,55
1477,PH175213000,Rammasun,2014,3,43,46
1478,PH175903000,Rammasun,2014,1,1,2
1479,PH175904000,Rammasun,2014,2,23,25
1480,PH175916000,Rammasun,2014,1,3,4
1481,PH175907000,Rammasun,2014,1,1,2
1482,PH175908000,Rammasun,2014,3,144,147
1483,PH175909000,Rammasun,2014,1,1,2
1484,PH175911000,Rammasun,2014,4,17,21
1485,PH175915000,Rammasun,2014,2,6,8
1486,PH175917000,Rammasun,2014,1,12,13
1487,PH050503000,Rammasun,2014,91,0,91
1488,PH050504000,Rammasun,2014,320,2086,2406
1489,PH050505000,Rammasun,2014,200,365,565
1490,PH050506000,Rammasun,2014,330,1372,1702
1491,PH050507000,Rammasun,2014,96,285,381
1492,PH050508000,Rammasun,2014,53,519,572
1493,PH050510000,Rammasun,2014,1722,6318,8040
1494,PH050511000,Rammasun,2014,513,2299,2812
1495,PH050516000,Rammasun,2014,215,1649,1864
1496,PH050518000,Rammasun,2014,1235,5027,6262
1497,PH051701000,Rammasun,2014,394,1807,2201
1498,PH051702000,Rammasun,2014,250,2550,2800
1499,PH051705000,Rammasun,2014,1193,6528,7721
1500,PH051706000,Rammasun,2014,934,4842,5776
1501,PH051707000,Rammasun,2014,696,2152,2848
1502,PH051708000,Rammasun,2014,1189,4556,5745
1503,PH051709000,Rammasun,2014,227,1679,1906
1504,PH051710000,Rammasun,2014,1036,3062,4098
1505,PH051712000,Rammasun,2014,295,2602,2897
1506,PH051713000,Rammasun,2014,382,1494,1876
1507,PH051715000,Rammasun,2014,378,2186,2564
1508,PH051716000,Rammasun,2014,780,4118,4898
1509,PH051717000,Rammasun,2014,170,968,1138
1510,PH051718000,Rammasun,2014,3340,12526,15866
1511,PH051719000,Rammasun,2014,315,3567,3882
1512,PH051720000,Rammasun,2014,578,2230,2808
1513,PH051721000,Rammasun,2014,372,2860,3232
1514,PH051722000,Rammasun,2014,1189,4556,5745
1515,PH051723000,Rammasun,2014,1314,7009,8323
1516,PH051724000,Rammasun,2014,284,1896,2180
1517,PH051725000,Rammasun,2014,1138,5152,6290
1518,PH051726000,Rammasun,2014,1191,4069,5260
1519,PH051728000,Rammasun,2014,1511,5162,6673
1520,PH051730000,Rammasun,2014,1546,8259,9805
1521,PH051732000,Rammasun,2014,5273,4475,9748
1522,PH051733000,Rammasun,2014,729,4114,4843
1523,PH051731000,Rammasun,2014,1274,5068,6342
1524,PH051734000,Rammasun,2014,1219,6354,7573
1525,PH051737000,Rammasun,2014,195,5378,5573
1526,PH051714000,Rammasun,2014,20,3,23
1527,PH051729000,Rammasun,2014,241,1910,2151
1528,PH051735000,Rammasun,2014,35,705,740
1529,PH051601000,Rammasun,2014,118,1639,1757
1530,PH051602000,Rammasun,2014,824,1285,2109
1531,PH051603000,Rammasun,2014,57,775,832
1532,PH051606000,Rammasun,2014,87,1593,1680
1533,PH051607000,Rammasun,2014,183,698,881
1534,PH051608000,Rammasun,2014,14,151,165
1535,PH051604000,Rammasun,2014,7,341,348
1536,PH051609000,Rammasun,2014,11,124,135
1537,PH051611000,Rammasun,2014,82,999,1081
1538,PH051610000,Rammasun,2014,161,2645,2806
1539,PH051612000,Rammasun,2014,73,868,941
1540,PH052002000,Rammasun,2014,4,81,85
1541,PH052010000,Rammasun,2014,21,16,37
1542,PH052011000,Rammasun,2014,73,766,839
1543,PH054106000,Rammasun,2014,123,14,137
1544,PH054108000,Rammasun,2014,4,31,35
1545,PH054113000,Rammasun,2014,10,121,131
1546,PH054114000,Rammasun,2014,77,574,651
1547,PH054119000,Rammasun,2014,16,74,90
1548,PH054120000,Rammasun,2014,53,455,508
1549,PH056202000,Rammasun,2014,282,1917,2199
1550,PH056203000,Rammasun,2014,218,1171,1389
1551,PH056204000,Rammasun,2014,225,2833,3058
1552,PH056205000,Rammasun,2014,418,2820,3238
1553,PH056206000,Rammasun,2014,271,1433,1704
1554,PH056208000,Rammasun,2014,1170,2008,3178
1555,PH056209000,Rammasun,2014,405,18,423
1556,PH056210000,Rammasun,2014,413,2357,2770
1557,PH056212000,Rammasun,2014,128,1721,1849
1558,PH056213000,Rammasun,2014,571,4405,4976
1559,PH056214000,Rammasun,2014,896,3533,4429
1560,PH084801000,Rammasun,2014,316,284,600
1561,PH084802000,Rammasun,2014,350,1634,1984
1562,PH084803000,Rammasun,2014,350,1634,1984
1563,PH084804000,Rammasun,2014,18,356,374
1564,PH084805000,Rammasun,2014,18,398,416
1565,PH084806000,Rammasun,2014,156,2174,2330
1566,PH084807000,Rammasun,2014,153,850,1003
1567,PH084808000,Rammasun,2014,1186,7200,8386
1568,PH084809000,Rammasun,2014,50,1442,1492
1569,PH084810000,Rammasun,2014,3,610,613
1570,PH084811000,Rammasun,2014,176,2077,2253
1571,PH084824000,Rammasun,2014,4,130,134
1572,PH084812000,Rammasun,2014,339,1245,1584
1573,PH084813000,Rammasun,2014,682,6155,6837
1574,PH084814000,Rammasun,2014,434,6340,6774
1575,PH084815000,Rammasun,2014,582,2833,3415
1576,PH084816000,Rammasun,2014,27,249,276
1577,PH084817000,Rammasun,2014,51,391,442
1578,PH084818000,Rammasun,2014,81,276,357
1579,PH084819000,Rammasun,2014,1015,2125,3140
1580,PH084820000,Rammasun,2014,555,564,1119
1581,PH084821000,Rammasun,2014,21,143,164
1582,PH084823000,Rammasun,2014,41,132,173
1583,PH082601000,Rammasun,2014,106,1960,2066
1584,PH082621000,Rammasun,2014,124,727,851
1585,PH082611000,Rammasun,2014,10,450,460
1586,PH086005000,Rammasun,2014,585,2485,3070
1587,PH086003000,Rammasun,2014,264,3185,3449
1588,PH086001000,Rammasun,2014,21,250,271
1589,PH086006000,Rammasun,2014,364,2662,3026
1590,PH086007000,Rammasun,2014,58,3578,3636
1591,PH086008000,Rammasun,2014,15,350,365
1592,PH086009000,Rammasun,2014,93,129,222
1593,PH086012000,Rammasun,2014,50,0,50
1594,PH086022000,Rammasun,2014,6,132,138
1595,PH086013000,Rammasun,2014,253,671,924
1596,PH086025000,Rammasun,2014,16,587,603
1597,PH086016000,Rammasun,2014,339,1878,2217
1598,PH086017000,Rammasun,2014,24,164,188
1599,PH086015000,Rammasun,2014,12,871,883
1600,PH086018000,Rammasun,2014,6,63,69
1601,PH086020000,Rammasun,2014,160,32,192
1602,PH086021000,Rammasun,2014,251,1530,1781
1603,PH086019000,Rammasun,2014,31,97,128
1604,PH148102000,Kalmaegi,2014,0,61,61
1605,PH148104000,Kalmaegi,2014,0,8,8
1606,PH148103000,Kalmaegi,2014,0,104,104
1607,PH013310000,Kalmaegi,2014,0,21,21
1608,PH148106000,Kalmaegi,2014,4,8,12
1609,PH148107000,Kalmaegi,2014,1,127,128
1610,PH141106000,Kalmaegi,2014,1,16,17
1611,PH143206000,Kalmaegi,2014,0,9,9
1612,PH143209000,Kalmaegi,2014,3,90,93
1613,PH012804000,Kalmaegi,2014,0,11,11
1614,PH012815000,Kalmaegi,2014,0,11,11
1615,PH013303000,Kalmaegi,2014,1,7,8
1616,PH013319000,Kalmaegi,2014,0,1,1
1617,PH013309000,Kalmaegi,2014,0,5,5
1618,PH013317000,Kalmaegi,2014,0,2,2
1619,PH015502000,Kalmaegi,2014,0,2,2
1620,PH015533000,Kalmaegi,2014,51,59,110
1621,PH015512000,Kalmaegi,2014,1,0,1
1622,PH015548000,Kalmaegi,2014,1,0,1
1623,PH015530000,Kalmaegi,2014,1,0,1
1624,PH015546000,Kalmaegi,2014,1,0,1
1625,PH015547000,Kalmaegi,2014,2,0,2
1626,PH015506000,Kalmaegi,2014,0,2,2
1627,PH015529000,Kalmaegi,2014,0,2,2
1628,PH015535000,Kalmaegi,2014,2,1,3
1629,PH021502000,Kalmaegi,2014,17,148,165
1630,PH021517000,Kalmaegi,2014,22,544,566
1631,PH021521000,Kalmaegi,2014,4,301,305
1632,PH021504000,Kalmaegi,2014,52,85,137
1633,PH021515000,Kalmaegi,2014,5,156,161
1634,PH021529000,Kalmaegi,2014,1,17,18
1635,PH023111000,Kalmaegi,2014,0,5,5
1636,PH025005000,Kalmaegi,2014,0,1,1
1637,PH025010000,Kalmaegi,2014,4,1,5
1638,PH140103000,Fung-wong,2014,0,14,14
1639,PH140114000,Fung-wong,2014,2,45,47
1640,PH140116000,Fung-wong,2014,5,43,48
1641,PH140118000,Fung-wong,2014,4,190,194
1642,PH140121000,Fung-wong,2014,0,67,67
1643,PH140123000,Fung-wong,2014,2,215,217
1644,PH140127000,Fung-wong,2014,2,137,139
1645,PH140101000,Fung-wong,2014,20,60,80
1646,PH140106000,Fung-wong,2014,0,13,13
1647,PH140107000,Fung-wong,2014,3,22,25
1648,PH140108000,Fung-wong,2014,3,113,116
1649,PH140109000,Fung-wong,2014,0,0,0
1650,PH140110000,Fung-wong,2014,1,11,12
1651,PH140113000,Fung-wong,2014,0,3,3
1652,PH140122000,Fung-wong,2014,0,32,32
1653,PH140124000,Fung-wong,2014,0,35,35
1654,PH148101000,Fung-wong,2014,0,3,3
1655,PH148107000,Fung-wong,2014,0,38,38
1656,PH141102000,Fung-wong,2014,2,0,2
1657,PH141113000,Fung-wong,2014,0,18,18
1658,PH141109000,Fung-wong,2014,0,5,5
1659,PH142704000,Fung-wong,2014,1,4,5
1660,PH142710000,Fung-wong,2014,8,134,142
1661,PH143206000,Fung-wong,2014,2,25,27
1662,PH144402000,Fung-wong,2014,8,8,16
1663,PH012801000,Fung-wong,2014,0,5,5
1664,PH012802000,Fung-wong,2014,1,4,5
1665,PH012804000,Fung-wong,2014,0,34,34
1666,PH012806000,Fung-wong,2014,1,241,242
1667,PH012810000,Fung-wong,2014,0,3,3
1668,PH012812000,Fung-wong,2014,3,112,115
1669,PH012815000,Fung-wong,2014,8,218,226
1670,PH012817000,Fung-wong,2014,0,37,37
1671,PH012818000,Fung-wong,2014,0,5,5
1672,PH012821000,Fung-wong,2014,1,38,39
1673,PH012823000,Fung-wong,2014,0,16,16
1674,PH012803000,Fung-wong,2014,10,15,25
1675,PH012811000,Fung-wong,2014,0,61,61
1676,PH012805000,Fung-wong,2014,26,112,138
1677,PH012808000,Fung-wong,2014,12,64,76
1678,PH012809000,Fung-wong,2014,2,4,6
1679,PH012813000,Fung-wong,2014,21,125,146
1680,PH012814000,Fung-wong,2014,89,4,93
1681,PH012816000,Fung-wong,2014,3,42,45
1682,PH012819000,Fung-wong,2014,0,4,4
1683,PH012820000,Fung-wong,2014,2,12,14
1684,PH012822000,Fung-wong,2014,0,11,11
1685,PH012903000,Fung-wong,2014,31,83,114
1686,PH012905000,Fung-wong,2014,74,1456,1530
1687,PH012907000,Fung-wong,2014,78,747,825
1688,PH012912000,Fung-wong,2014,1207,42,1249
1689,PH012919000,Fung-wong,2014,126,142,268
1690,PH012920000,Fung-wong,2014,161,359,520
1691,PH012921000,Fung-wong,2014,39,295,334
1692,PH012928000,Fung-wong,2014,35,949,984
1693,PH012934000,Fung-wong,2014,22,38,60
1694,PH012901000,Fung-wong,2014,1,19,20
1695,PH012906000,Fung-wong,2014,27,883,910
1696,PH012910000,Fung-wong,2014,0,46,46
1697,PH012913000,Fung-wong,2014,4,38,42
1698,PH012914000,Fung-wong,2014,163,190,353
1699,PH012917000,Fung-wong,2014,0,7,7
1700,PH012918000,Fung-wong,2014,5,654,659
1701,PH012922000,Fung-wong,2014,30,520,550
1702,PH012924000,Fung-wong,2014,48,1069,1117
1703,PH012926000,Fung-wong,2014,60,825,885
1704,PH012927000,Fung-wong,2014,358,1540,1898
1705,PH012929000,Fung-wong,2014,0,5,5
1706,PH012931000,Fung-wong,2014,0,76,76
1707,PH012932000,Fung-wong,2014,0,62,62
1708,PH012933000,Fung-wong,2014,7,240,247
1709,PH013303000,Fung-wong,2014,40,646,686
1710,PH013306000,Fung-wong,2014,7,389,396
1711,PH013310000,Fung-wong,2014,9,329,338
1712,PH013314000,Fung-wong,2014,1,5,6
1713,PH013315000,Fung-wong,2014,0,33,33
1714,PH013316000,Fung-wong,2014,1,101,102
1715,PH013318000,Fung-wong,2014,0,99,99
1716,PH013319000,Fung-wong,2014,3,98,101
1717,PH013301000,Fung-wong,2014,11,2,13
1718,PH013302000,Fung-wong,2014,1,74,75
1719,PH013304000,Fung-wong,2014,7,49,56
1720,PH013307000,Fung-wong,2014,1,7,8
1721,PH012806000,Fung-wong,2014,0,5,5
1722,PH013309000,Fung-wong,2014,1,37,38
1723,PH013311000,Fung-wong,2014,0,1,1
1724,PH015508000,Fung-wong,2014,10,130,140
1725,PH015522000,Fung-wong,2014,2,9,11
1726,PH025001000,Fung-wong,2014,1,78,79
1727,PH025011000,Fung-wong,2014,0,4,4
1728,PH025010000,Fung-wong,2014,1,20,21
1729,PH025012000,Fung-wong,2014,12,149,161
1730,PH031420000,Fung-wong,2014,7,24,31
1731,PH037104000,Fung-wong,2014,1,0,1
1732,PH037103000,Fung-wong,2014,2,5,7
1733,PH037108000,Fung-wong,2014,4,0,4
1734,PH041005000,Fung-wong,2014,1,0,1
1735,PH051728000,Fung-wong,2014,1,0,1
1736,PH043424000,Hagupit,2014,1,0,1
1737,PH045620000,Hagupit,2014,1,1,2
1738,PH045601000,Hagupit,2014,1,0,1
1739,PH045605000,Hagupit,2014,0,16,16
1740,PH045633000,Hagupit,2014,2,0,2
1741,PH175902000,Hagupit,2014,1,7,8
1742,PH175903000,Hagupit,2014,2,5,7
1743,PH175905000,Hagupit,2014,0,5,5
1744,PH175906000,Hagupit,2014,1,2,3
1745,PH175908000,Hagupit,2014,0,1,1
1746,PH175910000,Hagupit,2014,3,37,40
1747,PH175911000,Hagupit,2014,0,2,2
1748,PH175912000,Hagupit,2014,0,3,3
1749,PH175901000,Hagupit,2014,4,47,51
1750,PH175904000,Hagupit,2014,7,119,126
1751,PH175916000,Hagupit,2014,2,12,14
1752,PH175103000,Hagupit,2014,0,5,5
1753,PH050516000,Hagupit,2014,0,18,18
1754,PH051607000,Hagupit,2014,2,0,2
1755,PH051730000,Hagupit,2014,0,4,4
1756,PH051734000,Hagupit,2014,1,2,3
1757,PH051708000,Hagupit,2014,1,16,17
1758,PH051711000,Hagupit,2014,3,229,232
1759,PH051714000,Hagupit,2014,131,76,207
1760,PH051729000,Hagupit,2014,13,371,384
1761,PH051733000,Hagupit,2014,0,218,218
1762,PH051735000,Hagupit,2014,9,1,10
1763,PH051737000,Hagupit,2014,0,26,26
1764,PH051702000,Hagupit,2014,0,2130,2130
1765,PH051705000,Hagupit,2014,2,36,38
1766,PH051706000,Hagupit,2014,0,6,6
1767,PH052008000,Hagupit,2014,3,2,5
1768,PH052004000,Hagupit,2014,0,17,17
1769,PH052010000,Hagupit,2014,0,7,7
1770,PH054104000,Hagupit,2014,18,501,519
1771,PH054118000,Hagupit,2014,24,239,263
1772,PH054101000,Hagupit,2014,27,907,934
1773,PH054114000,Hagupit,2014,10,87,97
1774,PH054102000,Hagupit,2014,9,762,771
1775,PH054103000,Hagupit,2014,74,1949,2023
1776,PH054111000,Hagupit,2014,21,60,81
1777,PH054113000,Hagupit,2014,93,787,880
1778,PH041026000,Hagupit,2014,28,157,185
1779,PH054115000,Hagupit,2014,63,375,438
1780,PH054116000,Hagupit,2014,19,113,132
1781,PH054121000,Hagupit,2014,31,2876,2907
1782,PH054119000,Hagupit,2014,0,89,89
1783,PH054110000,Hagupit,2014,72,479,551
1784,PH054112000,Hagupit,2014,34,118,152
1785,PH054113000,Hagupit,2014,93,787,880
1786,PH054105000,Hagupit,2014,239,1470,1709
1787,PH054106000,Hagupit,2014,164,1739,1903
1788,PH054107000,Hagupit,2014,15,80,95
1789,PH054108000,Hagupit,2014,39,1885,1924
1790,PH054109000,Hagupit,2014,27,1885,1912
1791,PH054117000,Hagupit,2014,15,58,73
1792,PH056206000,Hagupit,2014,14,307,321
1793,PH056203000,Hagupit,2014,19,203,222
1794,PH056207000,Hagupit,2014,25,628,653
1795,PH056210000,Hagupit,2014,2,1649,1651
1796,PH056211000,Hagupit,2014,11,20,31
1797,PH056213000,Hagupit,2014,53,352,405
1798,PH056216000,Hagupit,2014,42,482,524
1799,PH056202000,Hagupit,2014,1,71,72
1800,PH056204000,Hagupit,2014,12,1195,1207
1801,PH056205000,Hagupit,2014,1,34,35
1802,PH056209000,Hagupit,2014,8,996,1004
1803,PH056212000,Hagupit,2014,79,764,843
1804,PH056214000,Hagupit,2014,23,292,315
1805,PH056215000,Hagupit,2014,10,53,63
1806,PH061915000,Hagupit,2014,1,97,98
1807,PH061916000,Hagupit,2014,3,11,14
1808,PH061904000,Hagupit,2014,0,1,1
1809,PH061903000,Hagupit,2014,0,917,917
1810,PH063005000,Hagupit,2014,8,406,414
1811,PH063014000,Hagupit,2014,189,245,434
1812,PH063019000,Hagupit,2014,12,459,471
1813,PH063027000,Hagupit,2014,1,1,2
1814,PH072252000,Hagupit,2014,1,0,1
1815,PH072228000,Hagupit,2014,0,2,2
1816,PH072208000,Hagupit,2014,1,20,21
1817,PH072221000,Hagupit,2014,264,1576,1840
1818,PH072231000,Hagupit,2014,26,266,292
1819,PH072243000,Hagupit,2014,0,9,9
1820,PH072244000,Hagupit,2014,1,129,130
1821,PH072248000,Hagupit,2014,39,387,426
1822,PH072218000,Hagupit,2014,5,81,86
1823,PH072242000,Hagupit,2014,22,59,81
1824,PH072247000,Hagupit,2014,1,182,183
1825,PH087802000,Hagupit,2014,132,1924,2056
1826,PH087802000,Hagupit,2014,25,65,90
1827,PH087803000,Hagupit,2014,98,1686,1784
1828,PH087807000,Hagupit,2014,9,173,182
1829,PH082601000,Hagupit,2014,1118,2643,3761
1830,PH082602000,Hagupit,2014,8,1448,1456
1831,PH082603000,Hagupit,2014,488,1828,2316
1832,PH082604000,Hagupit,2014,4156,9527,13683
1833,PH082605000,Hagupit,2014,1024,3875,4899
1834,PH082606000,Hagupit,2014,2761,7405,10166
1835,PH082607000,Hagupit,2014,93,2316,2409
1836,PH082608000,Hagupit,2014,22,266,288
1837,PH082609000,Hagupit,2014,31,799,830
1838,PH082610000,Hagupit,2014,79,712,791
1839,PH082611000,Hagupit,2014,126,1423,1549
1840,PH082612000,Hagupit,2014,19,2102,2121
1841,PH082613000,Hagupit,2014,253,4185,4438
1842,PH082614000,Hagupit,2014,109,684,793
1843,PH082615000,Hagupit,2014,371,2310,2681
1844,PH082616000,Hagupit,2014,8,417,425
1845,PH082617000,Hagupit,2014,3439,4118,7557
1846,PH082618000,Hagupit,2014,36,1278,1314
1847,PH082619000,Hagupit,2014,44,2471,2515
1848,PH082620000,Hagupit,2014,1033,2265,3298
1849,PH082621000,Hagupit,2014,1268,2338,3606
1850,PH082622000,Hagupit,2014,1616,2315,3931
1851,PH082623000,Hagupit,2014,1447,3316,4763
1852,PH083705000,Hagupit,2014,877,5254,6131
1853,PH083703000,Hagupit,2014,10,0,10
1854,PH083710000,Hagupit,2014,12,3,15
1855,PH083713000,Hagupit,2014,110,2079,2189
1856,PH083717000,Hagupit,2014,27,434,461
1857,PH083719000,Hagupit,2014,22,341,363
1858,PH083721000,Hagupit,2014,1,7,8
1859,PH083723000,Hagupit,2014,211,9458,9669
1860,PH083728000,Hagupit,2014,1,178,179
1861,PH083731000,Hagupit,2014,1,117,118
1862,PH083743000,Hagupit,2014,0,5200,5200
1863,PH084801000,Hagupit,2014,19,10,29
1864,PH084802000,Hagupit,2014,18,689,707
1865,PH084803000,Hagupit,2014,162,3856,4018
1866,PH084804000,Hagupit,2014,59,1043,1102
1867,PH101801000,Hagupit,2014,1246,13873,15119
1868,PH084806000,Hagupit,2014,256,2525,2781
1869,PH084807000,Hagupit,2014,250,1337,1587
1870,PH084808000,Hagupit,2014,495,3673,4168
1871,PH084809000,Hagupit,2014,480,2168,2648
1872,PH084810000,Hagupit,2014,546,3142,3688
1873,PH084811000,Hagupit,2014,207,2943,3150
1874,PH084824000,Hagupit,2014,170,1742,1912
1875,PH084812000,Hagupit,2014,401,1577,1978
1876,PH084813000,Hagupit,2014,416,3943,4359
1877,PH084814000,Hagupit,2014,89,1244,1333
1878,PH084815000,Hagupit,2014,567,3171,3738
1879,PH084816000,Hagupit,2014,3,513,516
1880,PH084817000,Hagupit,2014,105,1442,1547
1881,PH084818000,Hagupit,2014,65,1543,1608
1882,PH084819000,Hagupit,2014,375,420,795
1883,PH084820000,Hagupit,2014,137,2440,2577
1884,PH084821000,Hagupit,2014,29,677,706
1885,PH084822000,Hagupit,2014,728,1699,2427
1886,PH084823000,Hagupit,2014,54,820,874
1887,PH086001000,Hagupit,2014,54,275,329
1888,PH086002000,Hagupit,2014,340,1596,1936
1889,PH086003000,Hagupit,2014,36,9782,9818
1890,PH086004000,Hagupit,2014,1053,3613,4666
1891,PH086005000,Hagupit,2014,1755,10295,12050
1892,PH086006000,Hagupit,2014,1718,5776,7494
1893,PH086007000,Hagupit,2014,398,5067,5465
1894,PH086010000,Hagupit,2014,0,3420,3420
1895,PH086011000,Hagupit,2014,172,785,957
1896,PH086012000,Hagupit,2014,260,1594,1854
1897,PH086026000,Hagupit,2014,70,1215,1285
1898,PH086022000,Hagupit,2014,148,2911,3059
1899,PH086013000,Hagupit,2014,664,3111,3775
1900,PH086025000,Hagupit,2014,287,2930,3217
1901,PH086014000,Hagupit,2014,63,523,586
1902,PH086015000,Hagupit,2014,636,1155,1791
1903,PH086016000,Hagupit,2014,216,1710,1926
1904,PH035420000,Hagupit,2014,874,5539,6413
1905,PH086018000,Hagupit,2014,137,902,1039
1906,PH086024000,Hagupit,2014,70,1048,1118
1907,PH086019000,Hagupit,2014,719,1082,1801
1908,PH086020000,Hagupit,2014,499,4847,5346
1909,PH086021000,Hagupit,2014,1576,4116,5692
1910,PH086023000,Hagupit,2014,921,2439,3360
1911,PH086407000,Hagupit,2014,1,4,5
1912,PH086417000,Hagupit,2014,0,13,13
1913,PH086418000,Hagupit,2014,4,29,33
1914,PH166718000,Hagupit,2014,18,41,59
1915,PH166721000,Hagupit,2014,29,152,181
1916,PH050511000,Mekkhala,2015,15,15,30
1917,PH051603000,Mekkhala,2015,4,4,8
1918,PH051606000,Mekkhala,2015,1,1,2
1919,PH052010000,Mekkhala,2015,7,2,9
1920,PH056209000,Mekkhala,2015,1,1,2
1921,PH084801000,Mekkhala,2015,2473,20,2493
1922,PH084803000,Mekkhala,2015,1437,34,1471
1923,PH084805000,Mekkhala,2015,4190,118,4308
1924,PH084813000,Mekkhala,2015,6527,110,6637
1925,PH084816000,Mekkhala,2015,200,6,206
1926,PH084818000,Mekkhala,2015,733,15,748
1927,PH084821000,Mekkhala,2015,611,16,627
1928,PH084823000,Mekkhala,2015,352,6,358
1929,PH084807000,Mekkhala,2015,38,8,46
1930,PH084814000,Mekkhala,2015,3220,38,3258
1931,PH084815000,Mekkhala,2015,2183,220,2403
1932,PH084820000,Mekkhala,2015,786,58,844
1933,PH012801000,Goni,2015,0,30,30
1934,PH012802000,Goni,2015,2,1,3
1935,PH012804000,Goni,2015,1,8,9
1936,PH012811000,Goni,2015,0,1,1
1937,PH012805000,Goni,2015,0,3,3
1938,PH012806000,Goni,2015,1,19,20
1939,PH012809000,Goni,2015,0,1,1
1940,PH012812000,Goni,2015,0,10,10
1941,PH012813000,Goni,2015,4,6,10
1942,PH012815000,Goni,2015,5,106,111
1943,PH012817000,Goni,2015,1,8,9
1944,PH012818000,Goni,2015,1,7,8
1945,PH012821000,Goni,2015,5,10,15
1946,PH012822000,Goni,2015,0,26,26
1947,PH012823000,Goni,2015,0,3,3
1948,PH012909000,Goni,2015,0,10,10
1949,PH012919000,Goni,2015,0,3,3
1950,PH012920000,Goni,2015,0,11,11
1951,PH012921000,Goni,2015,20,66,86
1952,PH012926000,Goni,2015,0,5,5
1953,PH013314000,Goni,2015,0,2,2
1954,PH013317000,Goni,2015,0,9,9
1955,PH020903000,Goni,2015,44,159,203
1956,PH021505000,Goni,2015,15,908,923
1957,PH021507000,Goni,2015,8,872,880
1958,PH021510000,Goni,2015,4,7,11
1959,PH021511000,Goni,2015,0,254,254
1960,PH021522000,Goni,2015,12,940,952
1961,PH021523000,Goni,2015,5,834,839
1962,PH021524000,Goni,2015,5,680,685
1963,PH021525000,Goni,2015,0,9,9
1964,PH021528000,Goni,2015,12,0,12
1965,PH025012000,Goni,2015,0,20,20
1966,PH140101000,Goni,2015,1,4,5
1967,PH148101000,Goni,2015,0,56,56
1968,PH148102000,Goni,2015,1,61,62
1969,PH141101000,Goni,2015,1,7,8
1970,PH141102000,Goni,2015,4,7,11
1971,PH141103000,Goni,2015,1,4,5
1972,PH141105000,Goni,2015,3,30,33
1973,PH141106000,Goni,2015,3,3,6
1974,PH141107000,Goni,2015,0,1,1
1975,PH141108000,Goni,2015,0,67,67
1976,PH141112000,Goni,2015,1,0,1
1977,PH141113000,Goni,2015,0,12,12
1978,PH141114000,Goni,2015,1,25,26
1979,PH143201000,Goni,2015,10,54,64
1980,PH143206000,Goni,2015,4,57,61
1981,PH143208000,Goni,2015,4,18,22
1982,PH143209000,Goni,2015,0,17,17
1983,PH144408000,Goni,2015,4,4,8
1984,PH144402000,Goni,2015,0,7,7
1985,PH144407000,Goni,2015,1,0,1
1986,PH144409000,Goni,2015,0,2,2
1987,PH144410000,Goni,2015,0,20,20
1988,PH020903000,Noul,2015,0,36,36
1989,PH020906000,Noul,2015,4,81,85
1990,PH021523000,Noul,2015,49,1122,1171
1991,PH021525000,Noul,2015,3,49,52
1992,PH013301000,Mujigae,2015,0,0,0
1993,PH013312000,Mujigae,2015,0,0,0
1994,PH037701000,Mujigae,2015,27,101,128
1995,PH037705000,Mujigae,2015,0,0,0
1996,PH035417000,Mujigae,2015,60,334,394
1997,PH031402000,Mujigae,2015,0,0,0
1998,PH031404000,Mujigae,2015,0,0,0
1999,PH031406000,Mujigae,2015,0,0,0
2000,PH031412000,Mujigae,2015,0,0,0
2001,PH031417000,Mujigae,2015,0,0,0
2002,PH012919000,Mujigae,2015,0,0,0
2003,PH031421000,Mujigae,2015,0,0,0
2004,PH012926000,Mujigae,2015,0,18,18
2005,PH034902000,Mujigae,2015,0,0,0
2006,PH034903000,Mujigae,2015,0,0,0
2007,PH034907000,Mujigae,2015,10,150,160
2008,PH034912000,Mujigae,2015,0,0,0
2009,PH034913000,Mujigae,2015,0,0,0
2010,PH034914000,Mujigae,2015,0,0,0
2011,PH034919000,Mujigae,2015,0,0,0
2012,PH034926000,Mujigae,2015,0,3,3
2013,PH034927000,Mujigae,2015,0,0,0
2014,PH034928000,Mujigae,2015,0,0,0
2015,PH012924000,Mujigae,2015,0,0,0
2016,PH012806000,Koppu,2015,0,14,14
2017,PH012807000,Koppu,2015,0,20,20
2018,PH012814000,Koppu,2015,22,0,22
2019,PH012815000,Koppu,2015,1,28,29
2020,PH012902000,Koppu,2015,0,30,30
2021,PH012907000,Koppu,2015,1,8,9
2022,PH012909000,Koppu,2015,0,5,5
2023,PH012913000,Koppu,2015,0,8,8
2024,PH012914000,Koppu,2015,21,238,259
2025,PH012916000,Koppu,2015,3,4,7
2026,PH012917000,Koppu,2015,0,1,1
2027,PH012918000,Koppu,2015,0,1,1
2028,PH012921000,Koppu,2015,0,4,4
2029,PH012923000,Koppu,2015,1,10,11
2030,PH012924000,Koppu,2015,9,27,36
2031,PH012926000,Koppu,2015,11,10,21
2032,PH012927000,Koppu,2015,0,23,23
2033,PH012929000,Koppu,2015,0,5,5
2034,PH012931000,Koppu,2015,0,1,1
2035,PH012933000,Koppu,2015,0,75,75
2036,PH013301000,Koppu,2015,132,1368,1500
2037,PH013302000,Koppu,2015,5,53,58
2038,PH013303000,Koppu,2015,5,321,326
2039,PH013304000,Koppu,2015,15,287,302
2040,PH013305000,Koppu,2015,0,5,5
2041,PH013306000,Koppu,2015,0,509,509
2042,PH013307000,Koppu,2015,49,513,562
2043,PH013308000,Koppu,2015,11,97,108
2044,PH013309000,Koppu,2015,54,505,559
2045,PH013310000,Koppu,2015,7,779,786
2046,PH013311000,Koppu,2015,20,956,976
2047,PH013312000,Koppu,2015,8,24,32
2048,PH013313000,Koppu,2015,35,1659,1694
2049,PH013314000,Koppu,2015,0,90,90
2050,PH013315000,Koppu,2015,1,1,2
2051,PH013316000,Koppu,2015,10,346,356
2052,PH013317000,Koppu,2015,22,346,368
2053,PH013319000,Koppu,2015,8,18,26
2054,PH013320000,Koppu,2015,41,650,691
2055,PH015501000,Koppu,2015,6,333,339
2056,PH015502000,Koppu,2015,96,1073,1169
2057,PH015503000,Koppu,2015,1277,8770,10047
2058,PH015504000,Koppu,2015,69,1922,1991
2059,PH015505000,Koppu,2015,367,2938,3305
2060,PH015506000,Koppu,2015,6,62,68
2061,PH015507000,Koppu,2015,5,254,259
2062,PH015508000,Koppu,2015,333,4098,4431
2063,PH015509000,Koppu,2015,88,938,1026
2064,PH015511000,Koppu,2015,74,1237,1311
2065,PH015512000,Koppu,2015,1,35,36
2066,PH015513000,Koppu,2015,9,23,32
2067,PH015514000,Koppu,2015,525,6788,7313
2068,PH015516000,Koppu,2015,61,455,516
2069,PH015517000,Koppu,2015,57,1799,1856
2070,PH015518000,Koppu,2015,338,2164,2502
2071,PH015548000,Koppu,2015,15,194,209
2072,PH015522000,Koppu,2015,488,2066,2554
2073,PH015523000,Koppu,2015,1609,830,2439
2074,PH015525000,Koppu,2015,129,1536,1665
2075,PH015526000,Koppu,2015,3750,5350,9100
2076,PH015527000,Koppu,2015,127,548,675
2077,PH015528000,Koppu,2015,5,161,166
2078,PH015530000,Koppu,2015,11,65,76
2079,PH015532000,Koppu,2015,565,1973,2538
2080,PH015534000,Koppu,2015,43,141,184
2081,PH015535000,Koppu,2015,5,30,35
2082,PH015537000,Koppu,2015,0,2,2
2083,PH015538000,Koppu,2015,273,1338,1611
2084,PH015541000,Koppu,2015,22,1046,1068
2085,PH015542000,Koppu,2015,322,3000,3322
2086,PH015543000,Koppu,2015,0,4,4
2087,PH015545000,Koppu,2015,466,1554,2020
2088,PH015546000,Koppu,2015,58,114,172
2089,PH015547000,Koppu,2015,50,296,346
2090,PH020906000,Koppu,2015,0,374,374
2091,PH021516000,Koppu,2015,1,0,1
2092,PH021517000,Koppu,2015,1,6,7
2093,PH021521000,Koppu,2015,2,18,20
2094,PH023101000,Koppu,2015,3,39,42
2095,PH023102000,Koppu,2015,4,4,8
2096,PH023106000,Koppu,2015,4,16,20
2097,PH023108000,Koppu,2015,3,101,104
2098,PH023110000,Koppu,2015,32,308,340
2099,PH023115000,Koppu,2015,5,82,87
2100,PH023124000,Koppu,2015,3,4,7
2101,PH023127000,Koppu,2015,561,25,586
2102,PH023128000,Koppu,2015,0,54,54
2103,PH023129000,Koppu,2015,2,107,109
2104,PH023135000,Koppu,2015,3,159,162
2105,PH025015000,Koppu,2015,1,64,65
2106,PH025001000,Koppu,2015,2,50,52
2107,PH025002000,Koppu,2015,0,173,173
2108,PH025003000,Koppu,2015,22,3,25
2109,PH025004000,Koppu,2015,1,22,23
2110,PH025005000,Koppu,2015,1,28,29
2111,PH025006000,Koppu,2015,2,17,19
2112,PH025008000,Koppu,2015,3,16,19
2113,PH025009000,Koppu,2015,47,256,303
2114,PH025010000,Koppu,2015,23,154,177
2115,PH025012000,Koppu,2015,22,639,661
2116,PH025013000,Koppu,2015,2,5,7
2117,PH025701000,Koppu,2015,54,1581,1635
2118,PH025702000,Koppu,2015,24,402,426
2119,PH025703000,Koppu,2015,4,11,15
2120,PH025704000,Koppu,2015,292,5064,5356
2121,PH025706000,Koppu,2015,186,1738,1924
2122,PH025705000,Koppu,2015,7,584,591
2123,PH037701000,Koppu,2015,362,4624,4986
2124,PH037702000,Koppu,2015,863,4186,5049
2125,PH037703000,Koppu,2015,358,2410,2768
2126,PH037704000,Koppu,2015,134,1057,1191
2127,PH037705000,Koppu,2015,201,1939,2140
2128,PH037706000,Koppu,2015,116,1814,1930
2129,PH037707000,Koppu,2015,108,1776,1884
2130,PH037708000,Koppu,2015,553,2490,3043
2131,PH030804000,Koppu,2015,18,0,18
2132,PH030806000,Koppu,2015,2,10,12
2133,PH030807000,Koppu,2015,0,1,1
2134,PH031407000,Koppu,2015,0,30,30
2135,PH031413000,Koppu,2015,3,45,48
2136,PH031416000,Koppu,2015,0,36,36
2137,PH031421000,Koppu,2015,0,1,1
2138,PH034901000,Koppu,2015,9,455,464
2139,PH034904000,Koppu,2015,0,18,18
2140,PH034906000,Koppu,2015,9,169,178
2141,PH034907000,Koppu,2015,175,320,495
2142,PH034909000,Koppu,2015,118,864,982
2143,PH034910000,Koppu,2015,60,23,83
2144,PH034914000,Koppu,2015,40,2440,2480
2145,PH034919000,Koppu,2015,111,898,1009
2146,PH034920000,Koppu,2015,0,43,43
2147,PH034922000,Koppu,2015,23,387,410
2148,PH034923000,Koppu,2015,104,2108,2212
2149,PH034924000,Koppu,2015,15,22,37
2150,PH034925000,Koppu,2015,4,12,16
2151,PH034928000,Koppu,2015,2,12,14
2152,PH034917000,Koppu,2015,76,495,571
2153,PH034930000,Koppu,2015,167,2710,2877
2154,PH034931000,Koppu,2015,73,315,388
2155,PH034932000,Koppu,2015,1,257,258
2156,PH035401000,Koppu,2015,28,0,28
2157,PH035403000,Koppu,2015,4,368,372
2158,PH035405000,Koppu,2015,4,22,26
2159,PH035406000,Koppu,2015,2,44,46
2160,PH035410000,Koppu,2015,10,29,39
2161,PH036901000,Koppu,2015,5,149,154
2162,PH036902000,Koppu,2015,180,280,460
2163,PH036903000,Koppu,2015,55,312,367
2164,PH036904000,Koppu,2015,47,279,326
2165,PH036905000,Koppu,2015,4,22,26
2166,PH036906000,Koppu,2015,11,334,345
2167,PH036907000,Koppu,2015,3,40,43
2168,PH036908000,Koppu,2015,38,139,177
2169,PH036909000,Koppu,2015,40,178,218
2170,PH036910000,Koppu,2015,2,7,9
2171,PH036911000,Koppu,2015,4,286,290
2172,PH036912000,Koppu,2015,16,182,198
2173,PH036913000,Koppu,2015,65,163,228
2174,PH015535000,Koppu,2015,3,401,404
2175,PH036915000,Koppu,2015,2,2,4
2176,PH036916000,Koppu,2015,0,3,3
2177,PH036917000,Koppu,2015,7,3527,3534
2178,PH037101000,Koppu,2015,2,30,32
2179,PH037103000,Koppu,2015,0,3,3
2180,PH037104000,Koppu,2015,1,1,2
2181,PH037107000,Koppu,2015,13,0,13
2182,PH037113000,Koppu,2015,30,840,870
2183,PH045617000,Koppu,2015,966,60,1026
2184,PH045620000,Koppu,2015,289,2840,3129
2185,PH140110000,Koppu,2015,1,1,2
2186,PH140127000,Koppu,2015,0,12,12
2187,PH148102000,Koppu,2015,1,92,93
2188,PH148103000,Koppu,2015,0,16,16
2189,PH148104000,Koppu,2015,0,28,28
2190,PH148105000,Koppu,2015,4,0,4
2191,PH148107000,Koppu,2015,5,16,21
2192,PH141102000,Koppu,2015,40,346,386
2193,PH141103000,Koppu,2015,3,7,10
2194,PH141105000,Koppu,2015,0,9,9
2195,PH141106000,Koppu,2015,70,225,295
2196,PH141108000,Koppu,2015,10,132,142
2197,PH141110000,Koppu,2015,1,0,1
2198,PH141111000,Koppu,2015,0,50,50
2199,PH141112000,Koppu,2015,2,28,30
2200,PH141113000,Koppu,2015,1,60,61
2201,PH141114000,Koppu,2015,0,5,5
2202,PH142708000,Koppu,2015,2,10,12
2203,PH142707000,Koppu,2015,3,45,48
2204,PH142711000,Koppu,2015,0,11,11
2205,PH142701000,Koppu,2015,4,65,69
2206,PH142702000,Koppu,2015,18,238,256
2207,PH142706000,Koppu,2015,3,23,26
2208,PH142710000,Koppu,2015,13,107,120
2209,PH143201000,Koppu,2015,11,29,40
2210,PH143206000,Koppu,2015,1,402,403
2211,PH143208000,Koppu,2015,2,19,21
2212,PH143214000,Koppu,2015,1,4,5
2213,PH143215000,Koppu,2015,0,16,16
2214,PH143213000,Koppu,2015,2,11,13
2215,PH144405000,Koppu,2015,2,76,78
2216,PH144406000,Koppu,2015,0,5,5
2217,PH144408000,Koppu,2015,0,4,4
2218,PH144402000,Koppu,2015,0,5,5
2219,PH037707000,Melor,2015,9,8,17
2220,PH034920000,Melor,2015,3,0,3
2221,PH035403000,Melor,2015,0,3,3
2222,PH035418000,Melor,2015,0,3,3
2223,PH041005000,Melor,2015,4,0,4
2224,PH041008000,Melor,2015,0,7,7
2225,PH041010000,Melor,2015,2,8,10
2226,PH041019000,Melor,2015,0,22,22
2227,PH041025000,Melor,2015,0,54,54
2228,PH041027000,Melor,2015,1,24,25
2229,PH041032000,Melor,2015,0,2,2
2230,PH042121000,Melor,2015,8,0,8
2231,PH045640000,Melor,2015,0,836,836
2232,PH174001000,Melor,2015,23,230,253
2233,PH174002000,Melor,2015,465,3629,4094
2234,PH174003000,Melor,2015,25,135,160
2235,PH174004000,Melor,2015,5,145,150
2236,PH174005000,Melor,2015,2,38,40
2237,PH174006000,Melor,2015,50,378,428
2238,PH175101000,Melor,2015,50,92,142
2239,PH175103000,Melor,2015,6,148,154
2240,PH175104000,Melor,2015,51,647,698
2241,PH175107000,Melor,2015,6,8,14
2242,PH175110000,Melor,2015,0,1,1
2243,PH175201000,Melor,2015,2452,2961,5413
2244,PH175202000,Melor,2015,825,3508,4333
2245,PH175205000,Melor,2015,1130,4086,5216
2246,PH175206000,Melor,2015,2969,5942,8911
2247,PH175208000,Melor,2015,7893,12305,20198
2248,PH175209000,Melor,2015,10428,7366,17794
2249,PH175210000,Melor,2015,1852,3450,5302
2250,PH175211000,Melor,2015,84,633,717
2251,PH175213000,Melor,2015,311,437,748
2252,PH175214000,Melor,2015,2002,5314,7316
2253,PH175215000,Melor,2015,2741,3742,6483
2254,PH175902000,Melor,2015,256,1056,1312
2255,PH175903000,Melor,2015,2,4,6
2256,PH175904000,Melor,2015,8,274,282
2257,PH175905000,Melor,2015,774,377,1151
2258,PH175906000,Melor,2015,408,1546,1954
2259,PH175907000,Melor,2015,6,148,154
2260,PH175908000,Melor,2015,13,101,114
2261,PH175909000,Melor,2015,0,1,1
2262,PH175910000,Melor,2015,168,1209,1377
2263,PH175911000,Melor,2015,31,207,238
2264,PH175912000,Melor,2015,1,0,1
2265,PH175913000,Melor,2015,0,6,6
2266,PH175917000,Melor,2015,0,5,5
2267,PH050513000,Melor,2015,100,512,612
2268,PH050516000,Melor,2015,2,43,45
2269,PH051608000,Melor,2015,1,0,1
2270,PH051612000,Melor,2015,0,1,1
2271,PH051725000,Melor,2015,0,75,75
2272,PH052002000,Melor,2015,17,3,20
2273,PH052006000,Melor,2015,0,5,5
2274,PH054103000,Melor,2015,36,5,41
2275,PH054104000,Melor,2015,21,145,166
2276,PH054107000,Melor,2015,1658,2050,3708
2277,PH054110000,Melor,2015,3,75,78
2278,PH054114000,Melor,2015,964,1373,2337
2279,PH054118000,Melor,2015,90,237,327
2280,PH054119000,Melor,2015,161,730,891
2281,PH054120000,Melor,2015,246,1161,1407
2282,PH056202000,Melor,2015,1515,2448,3963
2283,PH056203000,Melor,2015,6169,8479,14648
2284,PH056204000,Melor,2015,1587,3237,4824
2285,PH056205000,Melor,2015,1733,4380,6113
2286,PH056206000,Melor,2015,1287,4197,5484
2287,PH056207000,Melor,2015,721,3960,4681
2288,PH056208000,Melor,2015,735,3014,3749
2289,PH056209000,Melor,2015,3440,3207,6647
2290,PH056210000,Melor,2015,1118,3555,4673
2291,PH056211000,Melor,2015,2020,3294,5314
2292,PH056212000,Melor,2015,3070,5038,8108
2293,PH056213000,Melor,2015,1690,5779,7469
2294,PH056214000,Melor,2015,305,1137,1442
2295,PH056215000,Melor,2015,1238,2092,3330
2296,PH056216000,Melor,2015,3293,3920,7213
2297,PH082601000,Melor,2015,19,1313,1332
2298,PH082611000,Melor,2015,30,1795,1825
2299,PH084801000,Melor,2015,2500,3046,5546
2300,PH084802000,Melor,2015,2229,744,2973
2301,PH084803000,Melor,2015,2623,3132,5755
2302,PH084804000,Melor,2015,314,1808,2122
2303,PH084805000,Melor,2015,1697,13873,15570
2304,PH084811000,Melor,2015,3100,2500,5600
2305,PH084824000,Melor,2015,106,1886,1992
2306,PH084813000,Melor,2015,3573,6155,9728
2307,PH084816000,Melor,2015,895,1475,2370
2308,PH084817000,Melor,2015,127,1361,1488
2309,PH084818000,Melor,2015,177,2455,2632
2310,PH084819000,Melor,2015,3780,1620,5400
2311,PH084821000,Melor,2015,26,280,306
2312,PH084823000,Melor,2015,179,886,1065
2313,PH084806000,Melor,2015,423,4715,5138
2314,PH084807000,Melor,2015,1256,3918,5174
2315,PH084808000,Melor,2015,8279,5295,13574
2316,PH084809000,Melor,2015,37,1430,1467
2317,PH084810000,Melor,2015,712,5923,6635
2318,PH084812000,Melor,2015,1083,1577,2660
2319,PH084814000,Melor,2015,2295,5862,8157
2320,PH084815000,Melor,2015,3714,3176,6890
2321,PH084820000,Melor,2015,1891,3699,5590
2322,PH084822000,Melor,2015,676,1897,2573
2323,PH086025000,Melor,2015,6,276,282
2324,PH086016000,Melor,2015,5,9,14
2325,PH012801000,Sarika,2016,1,30,31
2326,PH012802000,Sarika,2016,2,1,3
2327,PH012804000,Sarika,2016,1,8,9
2328,PH012805000,Sarika,2016,1,3,4
2329,PH012806000,Sarika,2016,1,19,20
2330,PH012809000,Sarika,2016,1,1,2
2331,PH012811000,Sarika,2016,1,1,2
2332,PH012812000,Sarika,2016,1,10,11
2333,PH012813000,Sarika,2016,4,6,10
2334,PH012815000,Sarika,2016,5,106,111
2335,PH012817000,Sarika,2016,1,8,9
2336,PH012818000,Sarika,2016,1,7,8
2337,PH012821000,Sarika,2016,5,10,15
2338,PH012822000,Sarika,2016,1,26,27
2339,PH012823000,Sarika,2016,1,3,4
2340,PH012909000,Sarika,2016,1,10,11
2341,PH012919000,Sarika,2016,1,3,4
2342,PH012920000,Sarika,2016,1,11,12
2343,PH012921000,Sarika,2016,20,66,86
2344,PH012926000,Sarika,2016,1,5,6
2345,PH013314000,Sarika,2016,1,2,3
2346,PH013317000,Sarika,2016,1,9,10
2347,PH021505000,Sarika,2016,15,908,923
2348,PH021507000,Sarika,2016,8,872,880
2349,PH021510000,Sarika,2016,4,7,11
2350,PH021511000,Sarika,2016,1,254,255
2351,PH021522000,Sarika,2016,12,940,952
2352,PH021523000,Sarika,2016,5,834,839
2353,PH021524000,Sarika,2016,5,680,685
2354,PH021525000,Sarika,2016,1,9,10
2355,PH021528000,Sarika,2016,12,1,13
2356,PH025012000,Sarika,2016,1,20,21
2357,PH034905000,Sarika,2016,4,6,10
2358,PH037107000,Sarika,2016,1,2,3
2359,PH037114000,Sarika,2016,1,4,5
2360,PH140101000,Sarika,2016,1,4,5
2361,PH141101000,Sarika,2016,1,7,8
2362,PH141102000,Sarika,2016,4,7,11
2363,PH141103000,Sarika,2016,1,4,5
2364,PH141105000,Sarika,2016,3,30,33
2365,PH141106000,Sarika,2016,3,3,6
2366,PH141107000,Sarika,2016,1,1,2
2367,PH141108000,Sarika,2016,1,67,68
2368,PH141112000,Sarika,2016,1,1,2
2369,PH141113000,Sarika,2016,1,12,13
2370,PH141114000,Sarika,2016,1,25,26
2371,PH143201000,Sarika,2016,10,54,64
2372,PH143206000,Sarika,2016,4,57,61
2373,PH143208000,Sarika,2016,4,18,22
2374,PH143209000,Sarika,2016,1,17,18
2375,PH144402000,Sarika,2016,1,7,8
2376,PH144407000,Sarika,2016,1,1,2
2377,PH144408000,Sarika,2016,4,4,8
2378,PH144409000,Sarika,2016,1,2,3
2379,PH144410000,Sarika,2016,1,20,21
2380,PH148101000,Sarika,2016,1,56,57
2381,PH148102000,Sarika,2016,1,61,62
2382,PH012801000,Haima,2016,1,50,51
2383,PH012802000,Haima,2016,53,351,404
2384,PH012803000,Haima,2016,137,1618,1755
2385,PH012804000,Haima,2016,7,332,339
2386,PH012805000,Haima,2016,1,212,213
2387,PH012806000,Haima,2016,1,375,376
2388,PH012807000,Haima,2016,1,30,31
2389,PH012808000,Haima,2016,2,89,91
2390,PH012809000,Haima,2016,6,162,168
2391,PH012810000,Haima,2016,2,9,11
2392,PH012811000,Haima,2016,16,158,174
2393,PH012812000,Haima,2016,39,485,524
2394,PH012813000,Haima,2016,2,48,50
2395,PH012814000,Haima,2016,156,190,346
2396,PH012815000,Haima,2016,21,677,698
2397,PH012816000,Haima,2016,25,896,921
2398,PH012817000,Haima,2016,17,236,253
2399,PH012818000,Haima,2016,6,53,59
2400,PH012819000,Haima,2016,60,895,955
2401,PH012820000,Haima,2016,1,72,73
2402,PH012821000,Haima,2016,2,71,73
2403,PH012822000,Haima,2016,28,205,233
2404,PH012823000,Haima,2016,2,52,54
2405,PH012901000,Haima,2016,1,59,60
2406,PH012902000,Haima,2016,5,241,246
2407,PH012903000,Haima,2016,107,5,112
2408,PH012904000,Haima,2016,1,956,957
2409,PH012905000,Haima,2016,192,1535,1727
2410,PH012906000,Haima,2016,94,954,1048
2411,PH012907000,Haima,2016,1,87,88
2412,PH012908000,Haima,2016,6,20,26
2413,PH012909000,Haima,2016,7,289,296
2414,PH012910000,Haima,2016,1,71,72
2415,PH012911000,Haima,2016,4,203,207
2416,PH012912000,Haima,2016,51,1202,1253
2417,PH012913000,Haima,2016,250,300,550
2418,PH012914000,Haima,2016,236,3521,3757
2419,PH012915000,Haima,2016,30,42,72
2420,PH012916000,Haima,2016,11,11,22
2421,PH012917000,Haima,2016,1,129,130
2422,PH012918000,Haima,2016,29,575,604
2423,PH012919000,Haima,2016,2,73,75
2424,PH012920000,Haima,2016,831,33,864
2425,PH012921000,Haima,2016,21,183,204
2426,PH012922000,Haima,2016,23,573,596
2427,PH012923000,Haima,2016,318,18,336
2428,PH012924000,Haima,2016,1,2,3
2429,PH012925000,Haima,2016,3,763,766
2430,PH012926000,Haima,2016,185,1898,2083
2431,PH012927000,Haima,2016,1,246,247
2432,PH012928000,Haima,2016,9,139,148
2433,PH012929000,Haima,2016,1,17,18
2434,PH012930000,Haima,2016,27,164,191
2435,PH012931000,Haima,2016,1,59,60
2436,PH012932000,Haima,2016,2,62,64
2437,PH012933000,Haima,2016,302,302,604
2438,PH012934000,Haima,2016,156,156,312
2439,PH013301000,Haima,2016,7,1,8
2440,PH013302000,Haima,2016,1,24,25
2441,PH013303000,Haima,2016,1,1,2
2442,PH013304000,Haima,2016,28,313,341
2443,PH013305000,Haima,2016,1,15,16
2444,PH013306000,Haima,2016,4,329,333
2445,PH013307000,Haima,2016,2,68,70
2446,PH013308000,Haima,2016,4,14,18
2447,PH013309000,Haima,2016,1,1,2
2448,PH013310000,Haima,2016,1,1,2
2449,PH013311000,Haima,2016,1,3,4
2450,PH013312000,Haima,2016,1,1,2
2451,PH013313000,Haima,2016,1,1,2
2452,PH013314000,Haima,2016,1,1,2
2453,PH013316000,Haima,2016,3,88,91
2454,PH013317000,Haima,2016,1,1,2
2455,PH013318000,Haima,2016,1,4,5
2456,PH013319000,Haima,2016,1,6,7
2457,PH013320000,Haima,2016,1,1,2
2458,PH015501000,Haima,2016,1,1,2
2459,PH015503000,Haima,2016,1,1,2
2460,PH015504000,Haima,2016,1,1,2
2461,PH015507000,Haima,2016,1,1,2
2462,PH015508000,Haima,2016,1,1,2
2463,PH015510000,Haima,2016,1,1,2
2464,PH015512000,Haima,2016,1,1,2
2465,PH015514000,Haima,2016,1,1,2
2466,PH015515000,Haima,2016,1,1,2
2467,PH015517000,Haima,2016,1,1,2
2468,PH015518000,Haima,2016,1,1,2
2469,PH015520000,Haima,2016,1,1,2
2470,PH015522000,Haima,2016,1,1,2
2471,PH015525000,Haima,2016,1,1,2
2472,PH015526000,Haima,2016,1,1,2
2473,PH015529000,Haima,2016,1,1,2
2474,PH015531000,Haima,2016,1,1,2
2475,PH015533000,Haima,2016,1,1,2
2476,PH015538000,Haima,2016,1,1,2
2477,PH015540000,Haima,2016,1,1,2
2478,PH015541000,Haima,2016,1,1,2
2479,PH015542000,Haima,2016,1,1,2
2480,PH015543000,Haima,2016,1,1,2
2481,PH015545000,Haima,2016,1,1,2
2482,PH015546000,Haima,2016,1,1,2
2483,PH015547000,Haima,2016,1,1,2
2484,PH015548000,Haima,2016,1,1,2
2485,PH021501000,Haima,2016,108,1554,1662
2486,PH021502000,Haima,2016,516,2266,2782
2487,PH021503000,Haima,2016,134,2041,2175
2488,PH021504000,Haima,2016,197,1474,1671
2489,PH021505000,Haima,2016,120,1021,1141
2490,PH021506000,Haima,2016,867,3464,4331
2491,PH021507000,Haima,2016,158,2122,2280
2492,PH021508000,Haima,2016,208,1714,1922
2493,PH021509000,Haima,2016,1,1,2
2494,PH021510000,Haima,2016,1,1,2
2495,PH021511000,Haima,2016,1,1,2
2496,PH021512000,Haima,2016,1361,5672,7033
2497,PH021513000,Haima,2016,1,1,2
2498,PH021514000,Haima,2016,1,1,2
2499,PH021515000,Haima,2016,1063,4490,5553
2500,PH021516000,Haima,2016,125,640,765
2501,PH021517000,Haima,2016,184,2679,2863
2502,PH021518000,Haima,2016,63,3467,3530
2503,PH021519000,Haima,2016,1025,7066,8091
2504,PH021520000,Haima,2016,227,682,909
2505,PH021521000,Haima,2016,252,2150,2402
2506,PH021522000,Haima,2016,38,2539,2577
2507,PH021523000,Haima,2016,1,1,2
2508,PH021524000,Haima,2016,1,1,2
2509,PH021525000,Haima,2016,61,420,481
2510,PH021526000,Haima,2016,1202,3960,5162
2511,PH021527000,Haima,2016,1,1,2
2512,PH021528000,Haima,2016,1,1,2
2513,PH021529000,Haima,2016,6571,16534,23105
2514,PH023101000,Haima,2016,24,237,261
2515,PH023102000,Haima,2016,1,1,2
2516,PH023103000,Haima,2016,16,395,411
2517,PH023104000,Haima,2016,29,423,452
2518,PH023105000,Haima,2016,73,1097,1170
2519,PH023106000,Haima,2016,1403,5665,7068
2520,PH023107000,Haima,2016,27,460,487
2521,PH023108000,Haima,2016,122,1732,1854
2522,PH023109000,Haima,2016,34,99,133
2523,PH023110000,Haima,2016,1,1,2
2524,PH023111000,Haima,2016,236,444,680
2525,PH023113000,Haima,2016,104,1368,1472
2526,PH023114000,Haima,2016,923,5094,6017
2527,PH023115000,Haima,2016,1,1,2
2528,PH023116000,Haima,2016,77,340,417
2529,PH023117000,Haima,2016,409,82,491
2530,PH023118000,Haima,2016,1243,3448,4691
2531,PH023119000,Haima,2016,24,369,393
2532,PH023120000,Haima,2016,10,62,72
2533,PH023121000,Haima,2016,1,1,2
2534,PH023122000,Haima,2016,455,2419,2874
2535,PH023123000,Haima,2016,32,176,208
2536,PH023124000,Haima,2016,12,14,26
2537,PH023125000,Haima,2016,60,643,703
2538,PH023126000,Haima,2016,90,1875,1965
2539,PH023127000,Haima,2016,1,16,17
2540,PH023128000,Haima,2016,1,61,62
2541,PH023129000,Haima,2016,17,132,149
2542,PH023130000,Haima,2016,67,835,902
2543,PH023131000,Haima,2016,1,1,2
2544,PH023132000,Haima,2016,1,1,2
2545,PH023133000,Haima,2016,173,1484,1657
2546,PH023134000,Haima,2016,1087,3411,4498
2547,PH023135000,Haima,2016,1,19,20
2548,PH023136000,Haima,2016,567,1571,2138
2549,PH023137000,Haima,2016,877,7442,8319
2550,PH025001000,Haima,2016,1,92,93
2551,PH025002000,Haima,2016,1,74,75
2552,PH025003000,Haima,2016,1,1,2
2553,PH025004000,Haima,2016,4,11,15
2554,PH025005000,Haima,2016,4,43,47
2555,PH025006000,Haima,2016,1,1,2
2556,PH025007000,Haima,2016,1,10,11
2557,PH025008000,Haima,2016,1,1,2
2558,PH025009000,Haima,2016,1,1,2
2559,PH025010000,Haima,2016,3,266,269
2560,PH025011000,Haima,2016,1,1,2
2561,PH025012000,Haima,2016,1,1,2
2562,PH025013000,Haima,2016,2,31,33
2563,PH025014000,Haima,2016,1,1,2
2564,PH025015000,Haima,2016,1,1,2
2565,PH025701000,Haima,2016,1,180,181
2566,PH025702000,Haima,2016,1,46,47
2567,PH025703000,Haima,2016,1,10,11
2568,PH025704000,Haima,2016,1,4,5
2569,PH025705000,Haima,2016,1,15,16
2570,PH025706000,Haima,2016,1,110,111
2571,PH031407000,Haima,2016,1,1,2
2572,PH031421000,Haima,2016,1,1,2
2573,PH034902000,Haima,2016,1,1,2
2574,PH034903000,Haima,2016,1,1,2
2575,PH034908000,Haima,2016,1,1,2
2576,PH034914000,Haima,2016,1,1,2
2577,PH034919000,Haima,2016,1,1,2
2578,PH034920000,Haima,2016,1,1,2
2579,PH034922000,Haima,2016,1,1,2
2580,PH034925000,Haima,2016,1,1,2
2581,PH034932000,Haima,2016,1,1,2
2582,PH035402000,Haima,2016,1,1,2
2583,PH035405000,Haima,2016,1,1,2
2584,PH035408000,Haima,2016,1,1,2
2585,PH035410000,Haima,2016,1,1,2
2586,PH035412000,Haima,2016,1,1,2
2587,PH035418000,Haima,2016,1,1,2
2588,PH036906000,Haima,2016,1,2,3
2589,PH036907000,Haima,2016,1,1,2
2590,PH036909000,Haima,2016,1,1,2
2591,PH036910000,Haima,2016,1,1,2
2592,PH036911000,Haima,2016,1,1,2
2593,PH036912000,Haima,2016,1,4,5
2594,PH036914000,Haima,2016,1,1,2
2595,PH037106000,Haima,2016,1,1,2
2596,PH037113000,Haima,2016,1,1,2
2597,PH037701000,Haima,2016,1,1,2
2598,PH037702000,Haima,2016,1,81,82
2599,PH037703000,Haima,2016,1,4,5
2600,PH037704000,Haima,2016,4,63,67
2601,PH037705000,Haima,2016,1,1,2
2602,PH037706000,Haima,2016,1,1,2
2603,PH037707000,Haima,2016,1,1,2
2604,PH037708000,Haima,2016,1,1,2
2605,PH051612000,Haima,2016,1,1,2
2606,PH140101000,Haima,2016,85,699,784
2607,PH140102000,Haima,2016,1,43,44
2608,PH140103000,Haima,2016,83,1166,1249
2609,PH140104000,Haima,2016,3,35,38
2610,PH140105000,Haima,2016,1,9,10
2611,PH140106000,Haima,2016,76,247,323
2612,PH140107000,Haima,2016,25,356,381
2613,PH140108000,Haima,2016,27,405,432
2614,PH140109000,Haima,2016,1,1,2
2615,PH140110000,Haima,2016,33,495,528
2616,PH140111000,Haima,2016,64,369,433
2617,PH140112000,Haima,2016,26,193,219
2618,PH140113000,Haima,2016,2,55,57
2619,PH140114000,Haima,2016,1,102,103
2620,PH140115000,Haima,2016,1,47,48
2621,PH140116000,Haima,2016,23,472,495
2622,PH140117000,Haima,2016,36,179,215
2623,PH140118000,Haima,2016,63,806,869
2624,PH140119000,Haima,2016,2,21,23
2625,PH140120000,Haima,2016,9,290,299
2626,PH140121000,Haima,2016,1,311,312
2627,PH140122000,Haima,2016,1,40,41
2628,PH140123000,Haima,2016,29,216,245
2629,PH140124000,Haima,2016,35,653,688
2630,PH140125000,Haima,2016,4,47,51
2631,PH140126000,Haima,2016,1,1,2
2632,PH140127000,Haima,2016,68,378,446
2633,PH141101000,Haima,2016,1,15,16
2634,PH141102000,Haima,2016,12,171,183
2635,PH141103000,Haima,2016,2,65,67
2636,PH141104000,Haima,2016,16,223,239
2637,PH141105000,Haima,2016,19,226,245
2638,PH141106000,Haima,2016,4,185,189
2639,PH141107000,Haima,2016,5,29,34
2640,PH141108000,Haima,2016,8,79,87
2641,PH141109000,Haima,2016,23,210,233
2642,PH141110000,Haima,2016,6,6,12
2643,PH141111000,Haima,2016,6,183,189
2644,PH141112000,Haima,2016,7,62,69
2645,PH141113000,Haima,2016,6,41,47
2646,PH141114000,Haima,2016,3,115,118
2647,PH142701000,Haima,2016,11,395,406
2648,PH142702000,Haima,2016,6,79,85
2649,PH142703000,Haima,2016,12,57,69
2650,PH142704000,Haima,2016,1,33,34
2651,PH142705000,Haima,2016,9,42,51
2652,PH142706000,Haima,2016,1,33,34
2653,PH142707000,Haima,2016,1,74,75
2654,PH142708000,Haima,2016,1,167,168
2655,PH142709000,Haima,2016,3,101,104
2656,PH142710000,Haima,2016,1,19,20
2657,PH142711000,Haima,2016,1,8,9
2658,PH143201000,Haima,2016,16,284,300
2659,PH143206000,Haima,2016,9,700,709
2660,PH143208000,Haima,2016,24,123,147
2661,PH143209000,Haima,2016,342,3475,3817
2662,PH143211000,Haima,2016,527,1920,2447
2663,PH143213000,Haima,2016,667,4934,5601
2664,PH143214000,Haima,2016,2,74,76
2665,PH143215000,Haima,2016,14,149,163
2666,PH144401000,Haima,2016,7,66,73
2667,PH144402000,Haima,2016,7,254,261
2668,PH144403000,Haima,2016,4,169,173
2669,PH144404000,Haima,2016,5,55,60
2670,PH144405000,Haima,2016,1,217,218
2671,PH144406000,Haima,2016,25,430,455
2672,PH144407000,Haima,2016,6,130,136
2673,PH144408000,Haima,2016,5,183,188
2674,PH144409000,Haima,2016,4,185,189
2675,PH144410000,Haima,2016,7,214,221
2676,PH148101000,Haima,2016,27,402,429
2677,PH148102000,Haima,2016,163,4112,4275
2678,PH148103000,Haima,2016,22,1737,1759
2679,PH148104000,Haima,2016,80,1186,1266
2680,PH148105000,Haima,2016,65,3600,3665
2681,PH148106000,Haima,2016,114,1341,1455
2682,PH148107000,Haima,2016,97,1092,1189
2683,PH041033000,Nock-Ten,2016,250,1303,1553
2684,PH045601000,Nock-Ten,2016,2,41,43
2685,PH045603000,Nock-Ten,2016,5,5,10
2686,PH045605000,Nock-Ten,2016,45,1231,1276
2687,PH045610000,Nock-Ten,2016,77,1654,1731
2688,PH045616000,Nock-Ten,2016,33,594,627
2689,PH045622000,Nock-Ten,2016,2,3,5
2690,PH045625000,Nock-Ten,2016,1,207,208
2691,PH045628000,Nock-Ten,2016,774,3343,4117
2692,PH045634000,Nock-Ten,2016,4,1139,1143
2693,PH045640000,Nock-Ten,2016,590,3102,3692
2694,PH045641000,Nock-Ten,2016,2,2,4
2695,PH045642000,Nock-Ten,2016,1745,14537,16282
2696,PH045644000,Nock-Ten,2016,1447,2509,3956
2697,PH045649000,Nock-Ten,2016,1,38,39
2698,PH050501000,Nock-Ten,2016,487,2713,3200
2699,PH050502000,Nock-Ten,2016,42,817,859
2700,PH050503000,Nock-Ten,2016,4,49,53
2701,PH050507000,Nock-Ten,2016,1550,3950,5500
2702,PH050508000,Nock-Ten,2016,590,1,591
2703,PH050509000,Nock-Ten,2016,529,2677,3206
2704,PH050512000,Nock-Ten,2016,2500,6000,8500
2705,PH050513000,Nock-Ten,2016,22,280,302
2706,PH050514000,Nock-Ten,2016,5438,10480,15918
2707,PH050515000,Nock-Ten,2016,244,1515,1759
2708,PH050516000,Nock-Ten,2016,395,636,1031
2709,PH050517000,Nock-Ten,2016,3706,8694,12400
2710,PH050518000,Nock-Ten,2016,3395,6770,10165
2711,PH051701000,Nock-Ten,2016,476,1826,2302
2712,PH051702000,Nock-Ten,2016,1018,4540,5558
2713,PH051703000,Nock-Ten,2016,1381,4675,6056
2714,PH051705000,Nock-Ten,2016,4125,7831,11956
2715,PH051710000,Nock-Ten,2016,512,3012,3524
2716,PH051713000,Nock-Ten,2016,4,53,57
2717,PH051714000,Nock-Ten,2016,51,1404,1455
2718,PH051715000,Nock-Ten,2016,308,1394,1702
2719,PH051716000,Nock-Ten,2016,3760,10016,13776
2720,PH051717000,Nock-Ten,2016,557,3271,3828
2721,PH051718000,Nock-Ten,2016,567,5676,6243
2722,PH051719000,Nock-Ten,2016,521,33,554
2723,PH051720000,Nock-Ten,2016,594,1433,2027
2724,PH051721000,Nock-Ten,2016,3168,896,4064
2725,PH051722000,Nock-Ten,2016,3395,5884,9279
2726,PH051725000,Nock-Ten,2016,1911,2628,4539
2727,PH051726000,Nock-Ten,2016,758,4248,5006
2728,PH051727000,Nock-Ten,2016,1650,3918,5568
2729,PH051728000,Nock-Ten,2016,5047,8603,13650
2730,PH051729000,Nock-Ten,2016,561,1803,2364
2731,PH051730000,Nock-Ten,2016,23,150,173
2732,PH051731000,Nock-Ten,2016,3894,3907,7801
2733,PH051733000,Nock-Ten,2016,2564,4349,6913
2734,PH051734000,Nock-Ten,2016,9,45,54
2735,PH051735000,Nock-Ten,2016,404,2383,2787
2736,PH051736000,Nock-Ten,2016,6295,8990,15285
2737,PH051737000,Nock-Ten,2016,138,1120,1258
2738,PH052001000,Nock-Ten,2016,33,1295,1328
2739,PH052002000,Nock-Ten,2016,1160,2404,3564
2740,PH052003000,Nock-Ten,2016,1493,3375,4868
2741,PH052004000,Nock-Ten,2016,109,501,610
2742,PH052005000,Nock-Ten,2016,189,671,860
2743,PH052006000,Nock-Ten,2016,16,164,180
2744,PH052007000,Nock-Ten,2016,47,953,1000
2745,PH052008000,Nock-Ten,2016,2112,3381,5493
2746,PH052010000,Nock-Ten,2016,1404,3272,4676
2747,PH052011000,Nock-Ten,2016,2486,7117,9603
2748,PH056216000,Nock-Ten,2016,6,61,67
2749,PH174001000,Nock-Ten,2016,1149,5672,6821
2750,PH174002000,Nock-Ten,2016,843,3675,4518
2751,PH174003000,Nock-Ten,2016,699,4137,4836
2752,PH174004000,Nock-Ten,2016,1012,3669,4681
2753,PH174005000,Nock-Ten,2016,1402,6223,7625
2754,PH174006000,Nock-Ten,2016,743,4300,5043
2755,PH175101000,Nock-Ten,2016,1,1,2
2756,PH175103000,Nock-Ten,2016,1,18,19
2757,PH175104000,Nock-Ten,2016,6,314,320
2758,PH175201000,Nock-Ten,2016,466,2399,2865
2759,PH175205000,Nock-Ten,2016,999,4067,5066
2760,PH175208000,Nock-Ten,2016,566,186,752
2761,PH175211000,Nock-Ten,2016,512,1368,1880
2762,PH175213000,Nock-Ten,2016,199,700,899
2763,PH175214000,Nock-Ten,2016,1,2,3
2764,PH175215000,Nock-Ten,2016,8,236,244
2765,PH012801000,Mangkhut,2018,1,297,298
2766,PH012802000,Mangkhut,2018,22,1834,1856
2767,PH012803000,Mangkhut,2018,194,2543,2737
2768,PH012804000,Mangkhut,2018,17,1149,1166
2769,PH012811000,Mangkhut,2018,46,776,822
2770,PH012805000,Mangkhut,2018,28,2798,2826
2771,PH012806000,Mangkhut,2018,27,588,615
2772,PH012807000,Mangkhut,2018,0,29,29
2773,PH012808000,Mangkhut,2018,37,783,820
2774,PH012809000,Mangkhut,2018,31,540,571
2775,PH012810000,Mangkhut,2018,3,108,111
2776,PH012812000,Mangkhut,2018,355,3799,4154
2777,PH012813000,Mangkhut,2018,33,747,780
2778,PH012814000,Mangkhut,2018,52,677,729
2779,PH012815000,Mangkhut,2018,106,2588,2694
2780,PH012816000,Mangkhut,2018,110,1974,2084
2781,PH012817000,Mangkhut,2018,62,1521,1583
2782,PH012818000,Mangkhut,2018,26,399,425
2783,PH012819000,Mangkhut,2018,37,1052,1089
2784,PH012820000,Mangkhut,2018,70,989,1059
2785,PH012821000,Mangkhut,2018,30,643,673
2786,PH012822000,Mangkhut,2018,18,218,236
2787,PH012823000,Mangkhut,2018,24,1163,1187
2788,PH012901000,Mangkhut,2018,1,84,85
2789,PH012902000,Mangkhut,2018,55,862,917
2790,PH012903000,Mangkhut,2018,50,789,839
2791,PH012903999,Mangkhut,2018,42,1418,1460
2792,PH012905000,Mangkhut,2018,121,4353,4474
2793,PH012906000,Mangkhut,2018,33,2520,2553
2794,PH012907000,Mangkhut,2018,41,1383,1424
2795,PH012908000,Mangkhut,2018,3,291,294
2796,PH012909000,Mangkhut,2018,17,595,612
2797,PH012910000,Mangkhut,2018,9,235,244
2798,PH012911000,Mangkhut,2018,7,284,291
2799,PH012912000,Mangkhut,2018,151,2267,2418
2800,PH012913000,Mangkhut,2018,6,65,71
2801,PH012914000,Mangkhut,2018,63,3791,3854
2802,PH012915000,Mangkhut,2018,7,162,169
2803,PH012916000,Mangkhut,2018,3,54,57
2804,PH012917000,Mangkhut,2018,9,0,9
2805,PH012918000,Mangkhut,2018,2,1407,1409
2806,PH012919000,Mangkhut,2018,0,258,258
2807,PH012920000,Mangkhut,2018,52,1208,1260
2808,PH012921000,Mangkhut,2018,22,341,363
2809,PH012922000,Mangkhut,2018,33,880,913
2810,PH012923000,Mangkhut,2018,28,1033,1061
2811,PH012924000,Mangkhut,2018,27,815,842
2812,PH012925000,Mangkhut,2018,49,2409,2458
2813,PH012926000,Mangkhut,2018,57,2826,2883
2814,PH012927000,Mangkhut,2018,111,1851,1962
2815,PH012928000,Mangkhut,2018,54,1797,1851
2816,PH012929000,Mangkhut,2018,0,33,33
2817,PH012930000,Mangkhut,2018,162,1635,1797
2818,PH012931000,Mangkhut,2018,0,31,31
2819,PH012932000,Mangkhut,2018,5,340,345
2820,PH012933000,Mangkhut,2018,34,1163,1197
2821,PH012934000,Mangkhut,2018,101,2189,2290
2822,PH013301000,Mangkhut,2018,21,744,765
2823,PH013302000,Mangkhut,2018,80,321,401
2824,PH013303000,Mangkhut,2018,6,1016,1022
2825,PH013304000,Mangkhut,2018,12,468,480
2826,PH013305000,Mangkhut,2018,8,143,151
2827,PH013306000,Mangkhut,2018,255,207,462
2828,PH013307000,Mangkhut,2018,17,598,615
2829,PH013307999,Mangkhut,2018,2,70,72
2830,PH013309000,Mangkhut,2018,126,431,557
2831,PH013310000,Mangkhut,2018,10,1020,1030
2832,PH013311000,Mangkhut,2018,74,753,827
2833,PH013312000,Mangkhut,2018,2,8,10
2834,PH013313000,Mangkhut,2018,23,95,118
2835,PH013314000,Mangkhut,2018,10,238,248
2836,PH013315000,Mangkhut,2018,0,16,16
2837,PH013316000,Mangkhut,2018,28,483,511
2838,PH013317000,Mangkhut,2018,10,152,162
2839,PH013318000,Mangkhut,2018,34,311,345
2840,PH013319000,Mangkhut,2018,2,8,10
2841,PH015501000,Mangkhut,2018,0,241,241
2842,PH015502000,Mangkhut,2018,42,319,361
2843,PH015504000,Mangkhut,2018,0,3,3
2844,PH015506000,Mangkhut,2018,5,21,26
2845,PH015507000,Mangkhut,2018,0,57,57
2846,PH015509000,Mangkhut,2018,0,28,28
2847,PH015510000,Mangkhut,2018,0,1,1
2848,PH015512000,Mangkhut,2018,1,2,3
2849,PH015515000,Mangkhut,2018,3,0,3
2850,PH015515999,Mangkhut,2018,3,292,295
2851,PH015517000,Mangkhut,2018,5,33,38
2852,PH015518000,Mangkhut,2018,48,791,839
2853,PH015520000,Mangkhut,2018,8,17,25
2854,PH015548000,Mangkhut,2018,5,116,121
2855,PH015522000,Mangkhut,2018,82,1192,1274
2856,PH015523000,Mangkhut,2018,9,792,801
2857,PH015524000,Mangkhut,2018,0,2,2
2858,PH015525000,Mangkhut,2018,0,2,2
2859,PH015526000,Mangkhut,2018,21,71,92
2860,PH015527000,Mangkhut,2018,5,160,165
2861,PH015528000,Mangkhut,2018,0,6,6
2862,PH015530000,Mangkhut,2018,2,1,3
2863,PH015532000,Mangkhut,2018,1,52,53
2864,PH015533000,Mangkhut,2018,60,380,440
2865,PH015535000,Mangkhut,2018,1,33,34
2866,PH015535999,Mangkhut,2018,11,3,14
2867,PH015537000,Mangkhut,2018,2,1,3
2868,PH015538000,Mangkhut,2018,73,190,263
2869,PH015539999,Mangkhut,2018,1,0,1
2870,PH015543000,Mangkhut,2018,2,5,7
2871,PH015547000,Mangkhut,2018,6,33,39
2872,PH021501000,Mangkhut,2018,595,6037,6632
2873,PH021501999,Mangkhut,2018,970,8423,9393
2874,PH021503000,Mangkhut,2018,1103,5338,6441
2875,PH021504000,Mangkhut,2018,2084,9340,11424
2876,PH021505000,Mangkhut,2018,897,9206,10103
2877,PH021506000,Mangkhut,2018,2249,13143,15392
2878,PH021507000,Mangkhut,2018,818,5880,6698
2879,PH021508000,Mangkhut,2018,434,3114,3548
2880,PH021509000,Mangkhut,2018,11,221,232
2881,PH021510000,Mangkhut,2018,349,2901,3250
2882,PH021511000,Mangkhut,2018,115,2305,2420
2883,PH021512000,Mangkhut,2018,118,2563,2681
2884,PH021513000,Mangkhut,2018,1250,9587,10837
2885,PH021514000,Mangkhut,2018,1225,6992,8217
2886,PH021515000,Mangkhut,2018,525,6835,7360
2887,PH021516000,Mangkhut,2018,690,6982,7672
2888,PH021517000,Mangkhut,2018,939,5527,6466
2889,PH021518000,Mangkhut,2018,143,1943,2086
2890,PH021519000,Mangkhut,2018,479,6217,6696
2891,PH021520000,Mangkhut,2018,453,3237,3690
2892,PH021521000,Mangkhut,2018,325,3587,3912
2893,PH021526000,Mangkhut,2018,238,4138,4376
2894,PH021523000,Mangkhut,2018,337,4295,4632
2895,PH021524000,Mangkhut,2018,34,470,504
2896,PH021525000,Mangkhut,2018,179,2479,2658
2897,PH021526000,Mangkhut,2018,577,5677,6254
2898,PH021527000,Mangkhut,2018,582,9166,9748
2899,PH021528000,Mangkhut,2018,386,10270,10656
2900,PH021529000,Mangkhut,2018,580,7694,8274
2901,PH023101000,Mangkhut,2018,18,91,109
2902,PH023102000,Mangkhut,2018,8,129,137
2903,PH023103000,Mangkhut,2018,3,151,154
2904,PH023104000,Mangkhut,2018,0,182,182
2905,PH012806000,Mangkhut,2018,4,319,323
2906,PH023106000,Mangkhut,2018,45,707,752
2907,PH023107000,Mangkhut,2018,17,350,367
2908,PH023108000,Mangkhut,2018,19,356,375
2909,PH023109000,Mangkhut,2018,0,22,22
2910,PH023118000,Mangkhut,2018,2,558,560
2911,PH023111000,Mangkhut,2018,18,207,225
2912,PH023112000,Mangkhut,2018,2,1,3
2913,PH023113000,Mangkhut,2018,11,259,270
2914,PH023114000,Mangkhut,2018,20,313,333
2915,PH013310000,Mangkhut,2018,11,249,260
2916,PH023117000,Mangkhut,2018,16,159,175
2917,PH023119000,Mangkhut,2018,5,249,254
2918,PH013311000,Mangkhut,2018,4,92,96
2919,PH023121000,Mangkhut,2018,10,814,824
2920,PH023122000,Mangkhut,2018,21,445,466
2921,PH023124000,Mangkhut,2018,0,2,2
2922,PH023125000,Mangkhut,2018,2,75,77
2923,PH023126000,Mangkhut,2018,9,304,313
2924,PH023127000,Mangkhut,2018,1,21,22
2925,PH023128000,Mangkhut,2018,13,7,20
2926,PH023129000,Mangkhut,2018,2,2,4
2927,PH015535000,Mangkhut,2018,16,189,205
2928,PH023131000,Mangkhut,2018,0,97,97
2929,PH023132000,Mangkhut,2018,0,18,18
2930,PH023133000,Mangkhut,2018,2,29,31
2931,PH012926000,Mangkhut,2018,33,281,314
2932,PH013317000,Mangkhut,2018,57,538,595
2933,PH023137000,Mangkhut,2018,4,143,147
2934,PH025001000,Mangkhut,2018,1,65,66
2935,PH025002000,Mangkhut,2018,2,154,156
2936,PH025003000,Mangkhut,2018,0,5,5
2937,PH025004000,Mangkhut,2018,2,20,22
2938,PH025005000,Mangkhut,2018,4,129,133
2939,PH025006000,Mangkhut,2018,3,13,16
2940,PH025007000,Mangkhut,2018,0,16,16
2941,PH025008000,Mangkhut,2018,4,21,25
2942,PH025009000,Mangkhut,2018,0,43,43
2943,PH025010000,Mangkhut,2018,7,283,290
2944,PH023122000,Mangkhut,2018,0,57,57
2945,PH025012000,Mangkhut,2018,6,211,217
2946,PH025013000,Mangkhut,2018,2,159,161
2947,PH025701000,Mangkhut,2018,0,84,84
2948,PH025702000,Mangkhut,2018,4,116,120
2949,PH025703000,Mangkhut,2018,8,55,63
2950,PH025704000,Mangkhut,2018,0,2,2
2951,PH025706000,Mangkhut,2018,0,5,5
2952,PH037701000,Mangkhut,2018,0,1,1
2953,PH037702000,Mangkhut,2018,0,6,6
2954,PH030802000,Mangkhut,2018,0,4,4
2955,PH030805000,Mangkhut,2018,0,5,5
2956,PH030807000,Mangkhut,2018,0,5,5
2957,PH030808000,Mangkhut,2018,0,7,7
2958,PH030810000,Mangkhut,2018,0,3,3
2959,PH031402000,Mangkhut,2018,1,4,5
2960,PH031407000,Mangkhut,2018,1,100,101
2961,PH031410000,Mangkhut,2018,4,1,5
2962,PH031420000,Mangkhut,2018,0,7,7
2963,PH034905000,Mangkhut,2018,13,148,161
2964,PH034906000,Mangkhut,2018,1,5,6
2965,PH034920000,Mangkhut,2018,2,4,6
2966,PH034921000,Mangkhut,2018,0,2,2
2967,PH034922999,Mangkhut,2018,0,19,19
2968,PH035402000,Mangkhut,2018,0,2,2
2969,PH035405000,Mangkhut,2018,0,1,1
2970,PH035413000,Mangkhut,2018,0,5,5
2971,PH035417000,Mangkhut,2018,0,3,3
2972,PH035420000,Mangkhut,2018,0,2,2
2973,PH036903000,Mangkhut,2018,1,2,3
2974,PH036904000,Mangkhut,2018,0,3,3
2975,PH036909000,Mangkhut,2018,3,3,6
2976,PH036913999,Mangkhut,2018,0,3,3
2977,PH036917000,Mangkhut,2018,1,0,1
2978,PH037101000,Mangkhut,2018,8,57,65
2979,PH037102000,Mangkhut,2018,0,1,1
2980,PH037103000,Mangkhut,2018,45,344,389
2981,PH037105000,Mangkhut,2018,6,96,102
2982,PH037106000,Mangkhut,2018,25,498,523
2983,PH037108000,Mangkhut,2018,1,41,42
2984,PH037108999,Mangkhut,2018,0,12,12
2985,PH037112000,Mangkhut,2018,3,30,33
2986,PH012924000,Mangkhut,2018,7,754,761
2987,PH140101000,Mangkhut,2018,158,3589,3747
2988,PH140103000,Mangkhut,2018,22,1092,1114
2989,PH140104000,Mangkhut,2018,0,44,44
2990,PH140106000,Mangkhut,2018,33,825,858
2991,PH140106999,Mangkhut,2018,2,481,483
2992,PH140107999,Mangkhut,2018,59,1914,1973
2993,PH140109000,Mangkhut,2018,0,23,23
2994,PH140110000,Mangkhut,2018,7,1101,1108
2995,PH140111000,Mangkhut,2018,5,761,766
2996,PH140112000,Mangkhut,2018,2,145,147
2997,PH140113000,Mangkhut,2018,4,147,151
2998,PH140114000,Mangkhut,2018,8,345,353
2999,PH140115000,Mangkhut,2018,0,10,10
3000,PH140116000,Mangkhut,2018,9,1563,1572
3001,PH140117000,Mangkhut,2018,4,1079,1083
3002,PH140118000,Mangkhut,2018,5,1016,1021
3003,PH140118999,Mangkhut,2018,35,1106,1141
3004,PH140120000,Mangkhut,2018,6,295,301
3005,PH140120999,Mangkhut,2018,5,319,324
3006,PH140121999,Mangkhut,2018,38,636,674
3007,PH140122999,Mangkhut,2018,10,394,404
3008,PH140124000,Mangkhut,2018,26,672,698
3009,PH140125000,Mangkhut,2018,19,114,133
3010,PH140126000,Mangkhut,2018,0,115,115
3011,PH140127000,Mangkhut,2018,5,173,178
3012,PH148101000,Mangkhut,2018,44,964,1008
3013,PH148102000,Mangkhut,2018,58,2550,2608
3014,PH148103000,Mangkhut,2018,135,2782,2917
3015,PH148104000,Mangkhut,2018,50,1363,1413
3016,PH148104999,Mangkhut,2018,151,3090,3241
3017,PH148106000,Mangkhut,2018,208,3093,3301
3018,PH148107000,Mangkhut,2018,71,2380,2451
3019,PH141101000,Mangkhut,2018,6,13,19
3020,PH141102000,Mangkhut,2018,112,322,434
3021,PH141103000,Mangkhut,2018,8,65,73
3022,PH141104000,Mangkhut,2018,49,276,325
3023,PH141105000,Mangkhut,2018,23,371,394
3024,PH141106000,Mangkhut,2018,149,928,1077
3025,PH141107000,Mangkhut,2018,20,267,287
3026,PH141108000,Mangkhut,2018,14,234,248
3027,PH141109000,Mangkhut,2018,9,50,59
3028,PH141110000,Mangkhut,2018,2,0,2
3029,PH141111000,Mangkhut,2018,2,35,37
3030,PH141112000,Mangkhut,2018,7,69,76
3031,PH141113000,Mangkhut,2018,68,326,394
3032,PH141114000,Mangkhut,2018,9,225,234
3033,PH142708000,Mangkhut,2018,4,23,27
3034,PH142707000,Mangkhut,2018,0,52,52
3035,PH142711000,Mangkhut,2018,3,25,28
3036,PH142701000,Mangkhut,2018,4,283,287
3037,PH142709000,Mangkhut,2018,0,23,23
3038,PH142702000,Mangkhut,2018,4,86,90
3039,PH142703000,Mangkhut,2018,0,29,29
3040,PH142704000,Mangkhut,2018,0,41,41
3041,PH142705000,Mangkhut,2018,0,35,35
3042,PH142706000,Mangkhut,2018,0,38,38
3043,PH142710000,Mangkhut,2018,11,51,62
3044,PH143201000,Mangkhut,2018,20,460,480
3045,PH143206000,Mangkhut,2018,5,144,149
3046,PH143208000,Mangkhut,2018,8,184,192
3047,PH143209000,Mangkhut,2018,24,889,913
3048,PH143214000,Mangkhut,2018,0,26,26
3049,PH143215000,Mangkhut,2018,1,37,38
3050,PH143211000,Mangkhut,2018,36,772,808
3051,PH143213000,Mangkhut,2018,10,147,157
3052,PH144404000,Mangkhut,2018,1,7,8
3053,PH144405000,Mangkhut,2018,1,234,235
3054,PH144406000,Mangkhut,2018,0,65,65
3055,PH144408000,Mangkhut,2018,0,16,16
3056,PH144402000,Mangkhut,2018,8,142,150
3057,PH144403000,Mangkhut,2018,3,50,53
3058,PH144407000,Mangkhut,2018,0,10,10
3059,PH144409000,Mangkhut,2018,0,5,5
3060,PH144410000,Mangkhut,2018,4,69,73
3061,PH041027000,Haiyan,2013,0,1,1
3062,PH041003000,Haiyan,2013,14,135,149
3063,PH041013000,Haiyan,2013,14,634,648
3064,PH043424000,Haiyan,2013,0,1,1
3065,PH043430000,Haiyan,2013,0,22,22
3066,PH043421000,Haiyan,2013,2,13,15
3067,PH037103000,Haiyan,2013,4,0,4
3068,PH175101000,Haiyan,2013,25,108,133
3069,PH175102000,Haiyan,2013,8,141,149
3070,PH175103000,Haiyan,2013,2,36,38
3071,PH175105000,Haiyan,2013,306,1407,1713
3072,PH175107000,Haiyan,2013,0,5,5
3073,PH175108000,Haiyan,2013,26,331,357
3074,PH175110000,Haiyan,2013,237,626,863
3075,PH175111000,Haiyan,2013,50,328,378
3076,PH174001000,Haiyan,2013,2,12,14
3077,PH174003000,Haiyan,2013,3,131,134
3078,PH174004000,Haiyan,2013,0,15,15
3079,PH175201000,Haiyan,2013,28,480,508
3080,PH175202000,Haiyan,2013,34,125,159
3081,PH175203000,Haiyan,2013,35,102,137
3082,PH175204000,Haiyan,2013,108,501,609
3083,PH175205000,Haiyan,2013,42,261,303
3084,PH175206000,Haiyan,2013,0,5,5
3085,PH175207000,Haiyan,2013,28,65,93
3086,PH175208000,Haiyan,2013,36,84,120
3087,PH175209000,Haiyan,2013,400,54,454
3088,PH175210000,Haiyan,2013,26,334,360
3089,PH175211000,Haiyan,2013,95,12,107
3090,PH175212000,Haiyan,2013,26,273,299
3091,PH175213000,Haiyan,2013,110,320,430
3092,PH175901000,Haiyan,2013,52,719,771
3093,PH175903000,Haiyan,2013,2,13,15
3094,PH175904000,Haiyan,2013,14,94,108
3095,PH175905000,Haiyan,2013,1,32,33
3096,PH175906000,Haiyan,2013,2,0,2
3097,PH175916000,Haiyan,2013,34,288,322
3098,PH175103000,Haiyan,2013,77,827,904
3099,PH175909000,Haiyan,2013,76,845,921
3100,PH175910000,Haiyan,2013,11,215,226
3101,PH175911000,Haiyan,2013,6,76,82
3102,PH175912000,Haiyan,2013,55,878,933
3103,PH175913000,Haiyan,2013,50,695,745
3104,PH175914000,Haiyan,2013,82,966,1048
3105,PH175915000,Haiyan,2013,105,1405,1510
3106,PH175917000,Haiyan,2013,7,42,49
3107,PH175302000,Haiyan,2013,1218,422,1640
3108,PH175307000,Haiyan,2013,1580,2607,4187
3109,PH175309000,Haiyan,2013,5021,3304,8325
3110,PH175322000,Haiyan,2013,1522,1478,3000
3111,PH175310000,Haiyan,2013,22,426,448
3112,PH175312000,Haiyan,2013,7,25,32
3113,PH175313000,Haiyan,2013,22,545,567
3114,PH175314000,Haiyan,2013,16,538,554
3115,PH175318000,Haiyan,2013,1,3,4
3116,PH175319000,Haiyan,2013,0,1,1
3117,PH175316000,Haiyan,2013,1,2,3
3118,PH050515000,Haiyan,2013,56,30,86
3119,PH050516000,Haiyan,2013,8,56,64
3120,PH051711000,Haiyan,2013,15,0,15
3121,PH051712000,Haiyan,2013,2,0,2
3122,PH051717000,Haiyan,2013,6,0,6
3123,PH051718000,Haiyan,2013,0,1,1
3124,PH051719000,Haiyan,2013,1,0,1
3125,PH051725000,Haiyan,2013,0,465,465
3126,PH051729000,Haiyan,2013,85,180,265
3127,PH051730000,Haiyan,2013,7,2,9
3128,PH051731000,Haiyan,2013,25,105,130
3129,PH051733000,Haiyan,2013,97,10,107
3130,PH051735000,Haiyan,2013,10,0,10
3131,PH054102000,Haiyan,2013,15,201,216
3132,PH054103000,Haiyan,2013,66,681,747
3133,PH054104000,Haiyan,2013,24,278,302
3134,PH054105000,Haiyan,2013,216,428,644
3135,PH054106000,Haiyan,2013,357,1443,1800
3136,PH054109000,Haiyan,2013,87,670,757
3137,PH054112000,Haiyan,2013,329,826,1155
3138,PH054114000,Haiyan,2013,0,1,1
3139,PH054115000,Haiyan,2013,25,198,223
3140,PH054117000,Haiyan,2013,181,1475,1656
3141,PH054116000,Haiyan,2013,157,509,666
3142,PH054120000,Haiyan,2013,5,16,21
3143,PH056203000,Haiyan,2013,60,424,484
3144,PH056204000,Haiyan,2013,0,267,267
3145,PH056208000,Haiyan,2013,3,78,81
3146,PH056212000,Haiyan,2013,38,934,972
3147,PH056213000,Haiyan,2013,27,302,329
3148,PH056216000,Haiyan,2013,6,172,178
3149,PH056215000,Haiyan,2013,12,99,111
3150,PH052002000,Haiyan,2013,28,16,44
3151,PH052003000,Haiyan,2013,26,66,92
3152,PH052005000,Haiyan,2013,29,1,30
3153,PH052006000,Haiyan,2013,1,5,6
3154,PH052010000,Haiyan,2013,0,5,5
3155,PH052011000,Haiyan,2013,84,80,164
3156,PH060401000,Haiyan,2013,3324,1846,5170
3157,PH060402000,Haiyan,2013,4809,893,5702
3158,PH060403000,Haiyan,2013,4673,3608,8281
3159,PH060404000,Haiyan,2013,3840,2700,6540
3160,PH060405000,Haiyan,2013,282,1914,2196
3161,PH060406000,Haiyan,2013,671,4284,4955
3162,PH060407000,Haiyan,2013,2717,7242,9959
3163,PH060408000,Haiyan,2013,768,2122,2890
3164,PH060409000,Haiyan,2013,3122,1450,4572
3165,PH060410000,Haiyan,2013,2138,1426,3564
3166,PH060411000,Haiyan,2013,1144,3152,4296
3167,PH060412000,Haiyan,2013,158,441,599
3168,PH050510000,Haiyan,2013,1126,3959,5085
3169,PH060414000,Haiyan,2013,660,2821,3481
3170,PH060415000,Haiyan,2013,3672,4086,7758
3171,PH060416000,Haiyan,2013,1043,5043,6086
3172,PH060417000,Haiyan,2013,591,2174,2765
3173,PH060601000,Haiyan,2013,16,237,253
3174,PH060602000,Haiyan,2013,2500,1582,4082
3175,PH060603000,Haiyan,2013,35,411,446
3176,PH060604000,Haiyan,2013,1015,3669,4684
3177,PH060605000,Haiyan,2013,735,3229,3964
3178,PH060606000,Haiyan,2013,2369,4460,6829
3179,PH060608000,Haiyan,2013,41,648,689
3180,PH060609000,Haiyan,2013,1414,3033,4447
3181,PH060610000,Haiyan,2013,715,1380,2095
3182,PH060611000,Haiyan,2013,1122,2210,3332
3183,PH060612000,Haiyan,2013,292,1976,2268
3184,PH060613000,Haiyan,2013,68,876,944
3185,PH060614000,Haiyan,2013,188,1392,1580
3186,PH060615000,Haiyan,2013,885,1979,2864
3187,PH060616000,Haiyan,2013,85,975,1060
3188,PH060617000,Haiyan,2013,2670,2563,5233
3189,PH060607000,Haiyan,2013,15,88,103
3190,PH060618000,Haiyan,2013,546,1545,2091
3191,PH061901000,Haiyan,2013,5211,297,5508
3192,PH061902000,Haiyan,2013,4815,2065,6880
3193,PH061903000,Haiyan,2013,4486,1855,6341
3194,PH061904000,Haiyan,2013,5401,4105,9506
3195,PH061905000,Haiyan,2013,4050,1200,5250
3196,PH061906000,Haiyan,2013,6910,299,7209
3197,PH061907000,Haiyan,2013,4039,3150,7189
3198,PH061908000,Haiyan,2013,4272,3438,7710
3199,PH061909000,Haiyan,2013,6264,1240,7504
3200,PH061910000,Haiyan,2013,7974,84,8058
3201,PH061911000,Haiyan,2013,4187,3521,7708
3202,PH061912000,Haiyan,2013,2068,1136,3204
3203,PH061913000,Haiyan,2013,4237,662,4899
3204,PH061914000,Haiyan,2013,13590,8056,21646
3205,PH061915000,Haiyan,2013,5022,365,5387
3206,PH061916000,Haiyan,2013,3700,2549,6249
3207,PH061917000,Haiyan,2013,5892,4548,10440
3208,PH067901000,Haiyan,2013,16,173,189
3209,PH067902000,Haiyan,2013,2,9,11
3210,PH067903000,Haiyan,2013,6,24,30
3211,PH067904000,Haiyan,2013,10,45,55
3212,PH067905000,Haiyan,2013,2,14,16
3213,PH063001000,Haiyan,2013,8416,1761,10177
3214,PH063002000,Haiyan,2013,20,236,256
3215,PH063003000,Haiyan,2013,1279,2812,4091
3216,PH063004000,Haiyan,2013,143,943,1086
3217,PH063005000,Haiyan,2013,3250,2989,6239
3218,PH063006000,Haiyan,2013,2202,4212,6414
3219,PH063007000,Haiyan,2013,475,2133,2608
3220,PH063008000,Haiyan,2013,3454,5556,9010
3221,PH063009000,Haiyan,2013,2013,1933,3946
3222,PH063010000,Haiyan,2013,1200,1374,2574
3223,PH063012000,Haiyan,2013,117,357,474
3224,PH063013000,Haiyan,2013,3812,4793,8605
3225,PH063014000,Haiyan,2013,7646,4517,12163
3226,PH036905000,Haiyan,2013,4225,4211,8436
3227,PH063016000,Haiyan,2013,1417,2818,4235
3228,PH063017000,Haiyan,2013,555,2420,2975
3229,PH063018000,Haiyan,2013,793,1858,2651
3230,PH063019000,Haiyan,2013,5994,3047,9041
3231,PH063020000,Haiyan,2013,22,40,62
3232,PH063021000,Haiyan,2013,153,515,668
3233,PH063022000,Haiyan,2013,73,121,194
3234,PH063023000,Haiyan,2013,536,2605,3141
3235,PH063025000,Haiyan,2013,2382,5224,7606
3236,PH063026000,Haiyan,2013,249,290,539
3237,PH063027000,Haiyan,2013,4082,1785,5867
3238,PH063028000,Haiyan,2013,55,80,135
3239,PH063029000,Haiyan,2013,160,220,380
3240,PH063030000,Haiyan,2013,361,34,395
3241,PH063031000,Haiyan,2013,88,190,278
3242,PH063032000,Haiyan,2013,49,121,170
3243,PH063036000,Haiyan,2013,61,1071,1132
3244,PH063037000,Haiyan,2013,189,1752,1941
3245,PH063038000,Haiyan,2013,4006,2694,6700
3246,PH063039000,Haiyan,2013,1925,1875,3800
3247,PH063040000,Haiyan,2013,29,38,67
3248,PH063041000,Haiyan,2013,29,416,445
3249,PH063042000,Haiyan,2013,1693,1407,3100
3250,PH063044000,Haiyan,2013,3929,6044,9973
3251,PH063043000,Haiyan,2013,3,0,3
3252,PH063045000,Haiyan,2013,0,0,0
3253,PH063046000,Haiyan,2013,66,243,309
3254,PH063035000,Haiyan,2013,7186,8285,15471
3255,PH063047000,Haiyan,2013,46,26,72
3256,PH184503000,Haiyan,2013,5,22,27
3257,PH184505000,Haiyan,2013,388,440,828
3258,PH184507000,Haiyan,2013,45,81,126
3259,PH184508000,Haiyan,2013,368,2120,2488
3260,PH184511000,Haiyan,2013,22,118,140
3261,PH184513000,Haiyan,2013,37,87,124
3262,PH184517000,Haiyan,2013,9,7,16
3263,PH184518000,Haiyan,2013,1264,4008,5272
3264,PH184519000,Haiyan,2013,0,4,4
3265,PH184520000,Haiyan,2013,26,98,124
3266,PH184521000,Haiyan,2013,19,94,113
3267,PH184522000,Haiyan,2013,5,169,174
3268,PH184532000,Haiyan,2013,22,120,142
3269,PH184525000,Haiyan,2013,4,47,51
3270,PH184529000,Haiyan,2013,233,1273,1506
3271,PH184530000,Haiyan,2013,19,409,428
3272,PH184532000,Haiyan,2013,93,715,808
3273,PH184502000,Haiyan,2013,13,18,31
3274,PH184504000,Haiyan,2013,5636,18574,24210
3275,PH184509000,Haiyan,2013,753,5285,6038
3276,PH184516000,Haiyan,2013,27,97,124
3277,PH184523000,Haiyan,2013,3426,9758,13184
3278,PH184524000,Haiyan,2013,41,92,133
3279,PH184526000,Haiyan,2013,191,1315,1506
3280,PH184527000,Haiyan,2013,5,8,13
3281,PH184528000,Haiyan,2013,51,399,450
3282,PH184531000,Haiyan,2013,638,4370,5008
3283,PH071209000,Haiyan,2013,1,1,2
3284,PH071217000,Haiyan,2013,3,13,16
3285,PH071220000,Haiyan,2013,2,0,2
3286,PH071221000,Haiyan,2013,0,11,11
3287,PH071223000,Haiyan,2013,0,13,13
3288,PH071224000,Haiyan,2013,30,0,30
3289,PH071233000,Haiyan,2013,1,8,9
3290,PH071235000,Haiyan,2013,11,90,101
3291,PH071238000,Haiyan,2013,135,1061,1196
3292,PH071240000,Haiyan,2013,1,1,2
3293,PH071243000,Haiyan,2013,7,400,407
3294,PH071244000,Haiyan,2013,0,12,12
3295,PH071246000,Haiyan,2013,6,162,168
3296,PH072205000,Haiyan,2013,0,7,7
3297,PH072206000,Haiyan,2013,62,127,189
3298,PH072209000,Haiyan,2013,10533,5743,16276
3299,PH072210000,Haiyan,2013,0,2,2
3300,PH072213000,Haiyan,2013,3820,1740,5560
3301,PH071212000,Haiyan,2013,156,893,1049
3302,PH072216000,Haiyan,2013,135,1218,1353
3303,PH072218000,Haiyan,2013,32,720,752
3304,PH072219000,Haiyan,2013,17,38,55
3305,PH072220000,Haiyan,2013,19,597,616
3306,PH072221000,Haiyan,2013,13660,622,14282
3307,PH072225000,Haiyan,2013,8,0,8
3308,PH072228000,Haiyan,2013,6134,319,6453
3309,PH072231000,Haiyan,2013,5092,4999,10091
3310,PH072232000,Haiyan,2013,18,33,51
3311,PH072234000,Haiyan,2013,30,398,428
3312,PH072236000,Haiyan,2013,737,1644,2381
3313,PH072237000,Haiyan,2013,20,192,212
3314,PH072238000,Haiyan,2013,657,291,948
3315,PH072241000,Haiyan,2013,0,34,34
3316,PH072242000,Haiyan,2013,444,3420,3864
3317,PH072243000,Haiyan,2013,4997,4023,9020
3318,PH072245000,Haiyan,2013,0,2,2
3319,PH072246000,Haiyan,2013,5,55,60
3320,PH072247000,Haiyan,2013,446,2359,2805
3321,PH072244000,Haiyan,2013,2327,2027,4354
3322,PH072248000,Haiyan,2013,2606,1120,3726
3323,PH072249000,Haiyan,2013,2175,2647,4822
3324,PH072252000,Haiyan,2013,577,4297,4874
3325,PH072253000,Haiyan,2013,1361,136,1497
3326,PH072211000,Haiyan,2013,6496,5869,12365
3327,PH072214000,Haiyan,2013,0,2,2
3328,PH072250000,Haiyan,2013,30,1027,1057
3329,PH184602000,Haiyan,2013,0,3,3
3330,PH184603000,Haiyan,2013,1,6,7
3331,PH184609000,Haiyan,2013,0,39,39
3332,PH184612000,Haiyan,2013,9,0,9
3333,PH184624000,Haiyan,2013,23,26,49
3334,PH184611000,Haiyan,2013,16,32,48
3335,PH184604000,Haiyan,2013,0,0,
3336,PH083701000,Haiyan,2013,4270,8006,12276
3337,PH083702000,Haiyan,2013,5873,3820,9693
3338,PH083703000,Haiyan,2013,4365,3263,7628
3339,PH083705000,Haiyan,2013,997,2571,3568
3340,PH083706000,Haiyan,2013,3825,2578,6403
3341,PH051703000,Haiyan,2013,4711,2866,7577
3342,PH083710000,Haiyan,2013,6526,3501,10027
3343,PH083713000,Haiyan,2013,2283,2447,4730
3344,PH083714000,Haiyan,2013,3516,2222,5738
3345,PH083715000,Haiyan,2013,4547,6163,10710
3346,PH083717000,Haiyan,2013,6772,0,6772
3347,PH083718000,Haiyan,2013,8104,780,8884
3348,PH083719000,Haiyan,2013,7514,4572,12086
3349,PH083720000,Haiyan,2013,2669,1624,4293
3350,PH083721000,Haiyan,2013,2633,1602,4235
3351,PH083722000,Haiyan,2013,5767,3508,9275
3352,PH083723000,Haiyan,2013,7020,372,7392
3353,PH083724000,Haiyan,2013,3159,1921,5080
3354,PH083725000,Haiyan,2013,2807,323,3130
3355,PH083726000,Haiyan,2013,9295,158,9453
3356,PH083728000,Haiyan,2013,2531,1540,4071
3357,PH083729000,Haiyan,2013,2389,6725,9114
3358,PH083730000,Haiyan,2013,3741,243,3984
3359,PH083731000,Haiyan,2013,250,2660,2910
3360,PH083733000,Haiyan,2013,2264,1372,3636
3361,PH083734000,Haiyan,2013,4114,2502,6616
3362,PH083735000,Haiyan,2013,2063,1191,3254
3363,PH083736000,Haiyan,2013,2501,1191,3692
3364,PH083739000,Haiyan,2013,13481,1435,14916
3365,PH083740000,Haiyan,2013,7165,4359,11524
3366,PH083741000,Haiyan,2013,3355,298,3653
3367,PH083742000,Haiyan,2013,2960,2003,4963
3368,PH083743000,Haiyan,2013,2323,1413,3736
3369,PH083744000,Haiyan,2013,2082,315,2397
3370,PH083745000,Haiyan,2013,4224,2570,6794
3371,PH083746000,Haiyan,2013,1301,792,2093
3372,PH083748000,Haiyan,2013,6670,3994,10664
3373,PH083749000,Haiyan,2013,2397,1416,3813
3374,PH083750000,Haiyan,2013,1247,139,1386
3375,PH083751000,Haiyan,2013,5136,3123,8259
3376,PH083708000,Haiyan,2013,6215,15666,21881
3377,PH083738000,Haiyan,2013,14132,26549,40681
3378,PH083747000,Haiyan,2013,12270,46553,58823
3379,PH087801000,Haiyan,2013,422,1186,1608
3380,PH087802000,Haiyan,2013,1261,2226,3487
3381,PH087803000,Haiyan,2013,1177,2898,4075
3382,PH087804000,Haiyan,2013,426,1039,1465
3383,PH087805000,Haiyan,2013,107,795,902
3384,PH087806000,Haiyan,2013,222,1254,1476
3385,PH087807000,Haiyan,2013,62,726,788
3386,PH087808000,Haiyan,2013,1767,4957,6724
3387,PH082601000,Haiyan,2013,53,734,787
3388,PH082602000,Haiyan,2013,2919,370,3289
3389,PH082603000,Haiyan,2013,584,1341,1925
3390,PH082604000,Haiyan,2013,1024,6948,7972
3391,PH082605000,Haiyan,2013,46,1566,1612
3392,PH082606000,Haiyan,2013,150,146,296
3393,PH082607000,Haiyan,2013,1529,1485,3014
3394,PH082608000,Haiyan,2013,1000,2971,3971
3395,PH082609000,Haiyan,2013,10008,1601,11609
3396,PH082610000,Haiyan,2013,1655,337,1992
3397,PH082611000,Haiyan,2013,205,150,355
3398,PH082612000,Haiyan,2013,2866,0,2866
3399,PH082613000,Haiyan,2013,673,3391,4064
3400,PH082614000,Haiyan,2013,0,7,7
3401,PH082615000,Haiyan,2013,1770,406,2176
3402,PH082616000,Haiyan,2013,183,1142,1325
3403,PH082618000,Haiyan,2013,2538,582,3120
3404,PH082619000,Haiyan,2013,2561,1344,3905
3405,PH082620000,Haiyan,2013,284,1203,1487
3406,PH082621000,Haiyan,2013,148,954,1102
3407,PH082622000,Haiyan,2013,279,2492,2771
3408,PH082623000,Haiyan,2013,150,1946,2096
3409,PH086001000,Haiyan,2013,150,1019,1169
3410,PH086002000,Haiyan,2013,1161,0,1161
3411,PH086006000,Haiyan,2013,0,658,658
3412,PH086010000,Haiyan,2013,2272,858,3130
3413,PH086011000,Haiyan,2013,2,32,34
3414,PH086022000,Haiyan,2013,55,915,970
3415,PH086013000,Haiyan,2013,565,768,1333
3416,PH086015000,Haiyan,2013,81,856,937
3417,PH086016000,Haiyan,2013,2,87,89
3418,PH086018000,Haiyan,2013,56,87,143
3419,PH086017000,Haiyan,2013,1155,3002,4157
3420,PH086019000,Haiyan,2013,248,1314,1562
3421,PH086023000,Haiyan,2013,304,1508,1812
3422,PH086005000,Haiyan,2013,33,1127,1160
3423,PH086401000,Haiyan,2013,20,281,301
3424,PH086402000,Haiyan,2013,110,952,1062
3425,PH086403000,Haiyan,2013,178,1186,1364
3426,PH086404000,Haiyan,2013,116,809,925
3427,PH086405000,Haiyan,2013,11,263,274
3428,PH086406000,Haiyan,2013,25,704,729
3429,PH086419000,Haiyan,2013,2,18,20
3430,PH086408000,Haiyan,2013,16,222,238
3431,PH086409000,Haiyan,2013,13,314,327
3432,PH086410000,Haiyan,2013,13,167,180
3433,PH086411000,Haiyan,2013,13,149,162
3434,PH086412000,Haiyan,2013,27,772,799
3435,PH086413000,Haiyan,2013,3,166,169
3436,PH086414000,Haiyan,2013,77,560,637
3437,PH086415000,Haiyan,2013,8,13,21
3438,PH086416000,Haiyan,2013,135,874,1009
3439,PH086417000,Haiyan,2013,102,1770,1872
3440,PH086418000,Haiyan,2013,39,147,186
3441,PH086407000,Haiyan,2013,25,165,190
3442,PH104308000,Haiyan,2013,0,3,3
3443,PH101805000,Haiyan,2013,0,1,1
3444,PH101803000,Haiyan,2013,2,9,11
3445,PH101804000,Haiyan,2013,0,5,5
3446,PH112503000,Haiyan,2013,0,3,3
3447,PH112505000,Haiyan,2013,5,3,8
3448,PH112508000,Haiyan,2013,3,0,3
3449,PH112511000,Haiyan,2013,2,0,2
3450,PH118603000,Haiyan,2013,1,2,3
3451,PH166701000,Haiyan,2013,2,2,4
3452,PH166702000,Haiyan,2013,1,44,45
3453,PH166704000,Haiyan,2013,2,66,68
3454,PH166707000,Haiyan,2013,7,75,82
3455,PH166708000,Haiyan,2013,27,1078,1105
3456,PH166715000,Haiyan,2013,0,98,98
3457,PH166719000,Haiyan,2013,0,0,0
3458,PH166716000,Haiyan,2013,10,889,899
3459,PH166717000,Haiyan,2013,0,21,21
3460,PH166718000,Haiyan,2013,3,357,360
3461,PH166722000,Haiyan,2013,4,67,71
3462,PH166723000,Haiyan,2013,0,5,5
3463,PH166724000,Haiyan,2013,2,12,14
3464,PH166812000,Haiyan,2013,44,79,123
3465,PH168502000,Haiyan,2013,12,25,37
3466,PH168501000,Haiyan,2013,27,331,358
3467,PH168504000,Haiyan,2013,0,290,290
3468,PH168505000,Haiyan,2013,245,874,1119
3469,PH168503000,Haiyan,2013,0,512,512
3470,PH168506000,Haiyan,2013,59,972,1031
3471,PH168507000,Haiyan,2013,19,401,420
3472,PH160308000,Haiyan,2013,2,40,42
3473,PH012801000,YUTU,2018,0,1,1
3474,PH012809000,YUTU,2018,13,1,14
3475,PH012922000,YUTU,2018,4,11,15
3476,PH013307000,YUTU,2018,2,59,61
3477,PH013312000,YUTU,2018,0,2,2
3478,PH013313000,YUTU,2018,0,84,84
3479,PH013314000,YUTU,2018,0,6,6
3480,PH013316000,YUTU,2018,0,8,8
3481,PH013317000,YUTU,2018,3,44,47
3482,PH015504000,YUTU,2018,1,0,1
3483,PH015511000,YUTU,2018,0,5,5
3484,PH015523000,YUTU,2018,0,23,23
3485,PH023101000,YUTU,2018,743,2841,3584
3486,PH023102000,YUTU,2018,344,3160,3504
3487,PH023103000,YUTU,2018,72,976,1048
3488,PH023104000,YUTU,2018,147,1361,1508
3489,PH012806000,YUTU,2018,37,746,783
3490,PH023106000,YUTU,2018,0,3,3
3491,PH023107000,YUTU,2018,167,2446,2613
3492,PH023108000,YUTU,2018,469,8882,9351
3493,PH023109000,YUTU,2018,358,3082,3440
3494,PH023110000,YUTU,2018,44,538,582
3495,PH023111000,YUTU,2018,4,513,517
3496,PH023112000,YUTU,2018,660,5930,6590
3497,PH023113000,YUTU,2018,59,705,764
3498,PH023114000,YUTU,2018,39,427,466
3499,PH023115000,YUTU,2018,155,1234,1389
3500,PH013310000,YUTU,2018,66,507,573
3501,PH023119000,YUTU,2018,4,34,38
3502,PH013311000,YUTU,2018,57,921,978
3503,PH023121000,YUTU,2018,157,2307,2464
3504,PH023123000,YUTU,2018,3,191,194
3505,PH023124000,YUTU,2018,575,2886,3461
3506,PH023125000,YUTU,2018,29,1051,1080
3507,PH023126000,YUTU,2018,65,666,731
3508,PH023127000,YUTU,2018,18,807,825
3509,PH023128000,YUTU,2018,135,520,655
3510,PH023129000,YUTU,2018,193,1568,1761
3511,PH015535000,YUTU,2018,123,1217,1340
3512,PH023131000,YUTU,2018,119,698,817
3513,PH023132000,YUTU,2018,232,1096,1328
3514,PH023135000,YUTU,2018,613,3715,4328
3515,PH025001000,YUTU,2018,1,130,131
3516,PH025002000,YUTU,2018,2,0,2
3517,PH025003000,YUTU,2018,34,200,234
3518,PH025004000,YUTU,2018,5,8,13
3519,PH025005000,YUTU,2018,15,84,99
3520,PH025006000,YUTU,2018,28,424,452
3521,PH025007000,YUTU,2018,1,0,1
3522,PH025009000,YUTU,2018,4,20,24
3523,PH025010000,YUTU,2018,4,36,40
3524,PH023122000,YUTU,2018,0,86,86
3525,PH025012000,YUTU,2018,0,8,8
3526,PH025013000,YUTU,2018,34,375,409
3527,PH025014000,YUTU,2018,11,61,72
3528,PH025701000,YUTU,2018,166,520,686
3529,PH025702000,YUTU,2018,31,424,455
3530,PH025703000,YUTU,2018,105,261,366
3531,PH025704000,YUTU,2018,12,36,48
3532,PH025706000,YUTU,2018,1,11,12
3533,PH025705000,YUTU,2018,128,1566,1694
3534,PH037702000,YUTU,2018,0,21,21
3535,PH037703000,YUTU,2018,30,620,650
3536,PH037706000,YUTU,2018,1,3,4
3537,PH084805000,YUTU,2018,0,81,81
3538,PH084812000,YUTU,2018,2,10,12
3539,PH084815000,YUTU,2018,3,13,16
3540,PH013310000,YUTU,2018,0,6,6
3541,PH141103000,YUTU,2018,0,1,1
3542,PH141109000,YUTU,2018,1,2,3
3543,PH141110000,YUTU,2018,0,5,5
3544,PH142708000,YUTU,2018,1,1,2
3545,PH142707000,YUTU,2018,141,1348,1489
3546,PH142711000,YUTU,2018,2,85,87
3547,PH142701000,YUTU,2018,10,140,150
3548,PH142709000,YUTU,2018,2,90,92
3549,PH142702000,YUTU,2018,0,6,6
3550,PH142703000,YUTU,2018,3,53,56
3551,PH142704000,YUTU,2018,2,49,51
3552,PH142705000,YUTU,2018,1,120,121
3553,PH142706000,YUTU,2018,4,303,307
3554,PH142710000,YUTU,2018,0,4,4
3555,PH143201000,YUTU,2018,2,18,20
3556,PH143206000,YUTU,2018,11,106,117
3557,PH143214000,YUTU,2018,11,14,25
3558,PH143215000,YUTU,2018,2,58,60
3559,PH144405000,YUTU,2018,58,601,659
3560,PH144406000,YUTU,2018,20,234,254
3561,PH144408000,YUTU,2018,4,25,29
3562,PH144402000,YUTU,2018,0,21,21
3563,PH144407000,YUTU,2018,0,1,1
3564,PH175102000,PHANFONE,2019,100,2092,2192
3565,PH103511000,PHANFONE,2019,613,4480,5093
3566,PH021521000,PHANFONE,2019,935,2283,3218
3567,PH175109000,PHANFONE,2019,259,0,259
3568,PH184617000,PHANFONE,2019,2755,11385,14140
3569,PH175204000,PHANFONE,2019,2658,2810,5468
3570,PH175211000,PHANFONE,2019,0,13,13
3571,PH023126000,PHANFONE,2019,5,20,25
3572,PH036917000,PHANFONE,2019,0,25,25
3573,PH072201000,PHANFONE,2019,24,107,131
3574,PH184505000,PHANFONE,2019,0,1,1
3575,PH175916000,PHANFONE,2019,3,40,43
3576,PH175103000,PHANFONE,2019,40,555,595
3577,PH175909000,PHANFONE,2019,0,48,48
3578,PH023127000,PHANFONE,2019,2,56,58
3579,PH045640000,PHANFONE,2019,3,3,6
3580,PH184617000,PHANFONE,2019,60,240,300
3581,PH025012000,PHANFONE,2019,124,1103,1227
3582,PH175917000,PHANFONE,2019,8,26,34
3583,PH060401000,PHANFONE,2019,170,5937,6107
3584,PH041004000,PHANFONE,2019,117,7021,7138
3585,PH060403000,PHANFONE,2019,813,8994,9807
3586,PH060404000,PHANFONE,2019,320,5885,6205
3587,PH060407000,PHANFONE,2019,1167,14869,16036
3588,PH060409000,PHANFONE,2019,9,137,146
3589,PH060410000,PHANFONE,2019,42,911,953
3590,PH060415000,PHANFONE,2019,1190,9133,10323
3591,PH060405000,PHANFONE,2019,487,4048,4535
3592,PH060406000,PHANFONE,2019,544,9948,10492
3593,PH060408000,PHANFONE,2019,259,3443,3702
3594,PH060411000,PHANFONE,2019,328,5127,5455
3595,PH060412000,PHANFONE,2019,793,6337,7130
3596,PH050510000,PHANFONE,2019,166,4435,4601
3597,PH060414000,PHANFONE,2019,986,7797,8783
3598,PH060416000,PHANFONE,2019,1170,7591,8761
3599,PH060417000,PHANFONE,2019,343,4583,4926
3600,PH060605000,PHANFONE,2019,1558,4581,6139
3601,PH060610000,PHANFONE,2019,132,3282,3414
3602,PH052006000,PHANFONE,2019,604,7790,8394
3603,PH060615000,PHANFONE,2019,108,693,801
3604,PH061901000,PHANFONE,2019,23,347,370
3605,PH061902000,PHANFONE,2019,9,200,209
3606,PH061903000,PHANFONE,2019,0,29,29
3607,PH061904000,PHANFONE,2019,0,7,7
3608,PH061905000,PHANFONE,2019,346,6477,6823
3609,PH061907000,PHANFONE,2019,177,2886,3063
3610,PH061908000,PHANFONE,2019,98,2868,2966
3611,PH061909000,PHANFONE,2019,2220,9139,11359
3612,PH061910000,PHANFONE,2019,34,419,453
3613,PH030811000,PHANFONE,2019,1557,10667,12224
3614,PH184521000,PHANFONE,2019,656,626,1282
3615,PH061913000,PHANFONE,2019,318,1865,2183
3616,PH061914000,PHANFONE,2019,7791,25765,33556
3617,PH061915000,PHANFONE,2019,860,3874,4734
3618,PH061916000,PHANFONE,2019,56,3617,3673
3619,PH063001000,PHANFONE,2019,27,5,32
3620,PH063005000,PHANFONE,2019,2844,6078,8922
3621,PH063006000,PHANFONE,2019,85,0,85
3622,PH063009000,PHANFONE,2019,395,4618,5013
3623,PH063014000,PHANFONE,2019,3505,14144,17649
3624,PH063019000,PHANFONE,2019,1493,9677,11170
3625,PH063038000,PHANFONE,2019,95,2628,2723
3626,PH031422000,PHANFONE,2019,2,16,18
3627,PH063044000,PHANFONE,2019,54,7777,7831
3628,PH072209000,PHANFONE,2019,61,67,128
3629,PH072211000,PHANFONE,2019,6,26,32
3630,PH072221000,PHANFONE,2019,5319,17118,22437
3631,PH072228000,PHANFONE,2019,96,1773,1869
3632,PH072231000,PHANFONE,2019,127,8813,8940
3633,PH060614000,PHANFONE,2019,7,6,13
3634,PH025012000,PHANFONE,2019,204,2408,2612
3635,PH072248000,PHANFONE,2019,1,2,3
3636,PH087801000,PHANFONE,2019,220,2133,2353
3637,PH087806000,PHANFONE,2019,410,1943,2353
3638,PH087808000,PHANFONE,2019,694,7153,7847
3639,PH087802000,PHANFONE,2019,220,3333,3553
3640,PH087803000,PHANFONE,2019,207,2961,3168
3641,PH087804000,PHANFONE,2019,509,3719,4228
3642,PH087805000,PHANFONE,2019,148,1083,1231
3643,PH087807000,PHANFONE,2019,25,415,440
3644,PH082604000,PHANFONE,2019,27,2258,2285
3645,PH082620000,PHANFONE,2019,3,121,124
3646,PH082602000,PHANFONE,2019,118,3234,3352
3647,PH082603000,PHANFONE,2019,182,2417,2599
3648,PH082607000,PHANFONE,2019,288,3159,3447
3649,PH082608000,PHANFONE,2019,415,3225,3640
3650,PH082609000,PHANFONE,2019,2111,10768,12879
3651,PH082610000,PHANFONE,2019,149,2034,2183
3652,PH082612000,PHANFONE,2019,119,2958,3077
3653,PH082613000,PHANFONE,2019,429,4760,5189
3654,PH051607000,PHANFONE,2019,517,1250,1767
3655,PH082618000,PHANFONE,2019,492,3411,3903
3656,PH082619000,PHANFONE,2019,315,3386,3701
3657,PH083702000,PHANFONE,2019,569,4450,5019
3658,PH083705000,PHANFONE,2019,419,6492,6911
3659,PH083739000,PHANFONE,2019,197,6375,6572
3660,PH031421000,PHANFONE,2019,80,2715,2795
3661,PH025012000,PHANFONE,2019,675,2445,3120
3662,PH083747000,PHANFONE,2019,968,25423,26391
3663,PH083748000,PHANFONE,2019,568,7839,8407
3664,PH083749000,PHANFONE,2019,291,5010,5301
3665,PH083706000,PHANFONE,2019,76,2572,2648
3666,PH083714000,PHANFONE,2019,420,5598,6018
3667,PH083715000,PHANFONE,2019,177,5766,5943
3668,PH083717000,PHANFONE,2019,60,4664,4724
3669,PH083718000,PHANFONE,2019,18,1101,1119
3670,PH083723000,PHANFONE,2019,67,4308,4375
3671,PH036907000,PHANFONE,2019,0,3,3
3672,PH083730000,PHANFONE,2019,1,0,1
3673,PH083735000,PHANFONE,2019,1,0,1
3674,PH083741000,PHANFONE,2019,140,3733,3873
3675,PH083746000,PHANFONE,2019,35,2581,2616
3676,PH083750000,PHANFONE,2019,50,1955,2005
3677,PH083713000,PHANFONE,2019,317,7255,7572
3678,PH083729000,PHANFONE,2019,315,5803,6118
3679,PH023129000,PHANFONE,2019,454,5406,5860
3680,PH083745000,PHANFONE,2019,467,8029,8496
3681,PH083751000,PHANFONE,2019,626,6066,6692
3682,PH083703000,PHANFONE,2019,23,577,600
3683,PH083722000,PHANFONE,2019,1,4,5
3684,PH083733000,PHANFONE,2019,26,116,142
3685,PH083738000,PHANFONE,2019,151,2589,2740
3686,PH083740000,PHANFONE,2019,32,557,589
3687,PH083708000,PHANFONE,2019,3,22,25
3688,PH083719000,PHANFONE,2019,0,11,11
3689,PH086001000,PHANFONE,2019,8,289,297
3690,PH086026000,PHANFONE,2019,1,0,1
3691,PH086018000,PHANFONE,2019,37,263,300
3692,PH086024000,PHANFONE,2019,29,189,218
3693,PH086020000,PHANFONE,2019,9,114,123
3694,PH086002000,PHANFONE,2019,860,12096,12956
3695,PH086004000,PHANFONE,2019,33,1497,1530
3696,PH086005000,PHANFONE,2019,15,708,723
3697,PH086006000,PHANFONE,2019,1124,4956,6080
3698,PH086008000,PHANFONE,2019,6,294,300
3699,PH086009000,PHANFONE,2019,0,5,5
3700,PH086010000,PHANFONE,2019,98,1967,2065
3701,PH086012000,PHANFONE,2019,0,34,34
3702,PH086022000,PHANFONE,2019,0,146,146
3703,PH086013000,PHANFONE,2019,227,3644,3871
3704,PH086015000,PHANFONE,2019,12,513,525
3705,PH035420000,PHANFONE,2019,1019,8727,9746
3706,PH086019000,PHANFONE,2019,132,1882,2014
3707,PH086021000,PHANFONE,2019,242,4061,4303
3708,PH086023000,PHANFONE,2019,93,2741,2834
3709,PH175104000,NAKRI,2019,0,0,
3710,PH175107000,NAKRI,2019,7,16,23
3711,PH021521000,NAKRI,2019,10,38,48
3712,PH175109000,NAKRI,2019,0,4,4
3713,PH012924000,NAKRI,2019,1,17,18
3714,PH021501000,KAMMURI,2019,1,0,1
3715,PH021511000,KAMMURI,2019,3,0,3
3716,PH021522000,KAMMURI,2019,2,2,4
3717,PH021523000,KAMMURI,2019,5,0,5
3718,PH021524000,KAMMURI,2019,1,1,2
3719,PH023111000,KAMMURI,2019,63,0,63
3720,PH025012000,KAMMURI,2019,0,2,2
3721,PH037705000,KAMMURI,2019,1,120,121
3722,PH041005000,KAMMURI,2019,21,357,378
3723,PH041008000,KAMMURI,2019,0,6,6
3724,PH041010000,KAMMURI,2019,0,5,5
3725,PH041012000,KAMMURI,2019,7,93,100
3726,PH013313000,KAMMURI,2019,6,104,110
3727,PH013316000,KAMMURI,2019,2,56,58
3728,PH035417000,KAMMURI,2019,1,0,1
3729,PH012820000,KAMMURI,2019,0,6,6
3730,PH041026000,KAMMURI,2019,0,10,10
3731,PH021525000,KAMMURI,2019,0,3,3
3732,PH041032000,KAMMURI,2019,4,58,62
3733,PH041033000,KAMMURI,2019,4,210,214
3734,PH041034000,KAMMURI,2019,1,0,1
3735,PH042121000,KAMMURI,2019,8,0,8
3736,PH043401000,KAMMURI,2019,0,5,5
3737,PH043402000,KAMMURI,2019,2,0,2
3738,PH043405000,KAMMURI,2019,12,3,15
3739,PH043407000,KAMMURI,2019,15,170,185
3740,PH043408000,KAMMURI,2019,3,54,57
3741,PH043409000,KAMMURI,2019,5,5,10
3742,PH043410000,KAMMURI,2019,0,6,6
3743,PH043412000,KAMMURI,2019,2,74,76
3744,PH043415000,KAMMURI,2019,0,68,68
3745,PH043421000,KAMMURI,2019,9,23,32
3746,PH012926000,KAMMURI,2019,0,15,15
3747,PH045601000,KAMMURI,2019,44,671,715
3748,PH045602000,KAMMURI,2019,7,67,74
3749,PH045603000,KAMMURI,2019,163,83,246
3750,PH045607000,KAMMURI,2019,87,1,88
3751,PH037103000,KAMMURI,2019,3,15,18
3752,PH045610000,KAMMURI,2019,117,0,117
3753,PH045615000,KAMMURI,2019,29,524,553
3754,PH045616000,KAMMURI,2019,43,438,481
3755,PH045617000,KAMMURI,2019,65,668,733
3756,PH045618000,KAMMURI,2019,17,240,257
3757,PH045619000,KAMMURI,2019,56,227,283
3758,PH015520000,KAMMURI,2019,65,626,691
3759,PH045622000,KAMMURI,2019,121,519,640
3760,PH045625000,KAMMURI,2019,57,939,996
3761,PH045627000,KAMMURI,2019,100,1578,1678
3762,PH045628000,KAMMURI,2019,359,26,385
3763,PH045629000,KAMMURI,2019,105,720,825
3764,PH045633000,KAMMURI,2019,48,215,263
3765,PH045634000,KAMMURI,2019,35,598,633
3766,PH031417000,KAMMURI,2019,5,791,796
3767,PH045636000,KAMMURI,2019,3,165,168
3768,PH023122000,KAMMURI,2019,31,111,142
3769,PH045638000,KAMMURI,2019,19,265,284
3770,PH045639000,KAMMURI,2019,9,330,339
3771,PH034924000,KAMMURI,2019,0,13,13
3772,PH045646000,KAMMURI,2019,78,1326,1404
3773,PH045647000,KAMMURI,2019,140,0,140
3774,PH045648000,KAMMURI,2019,5,52,57
3775,PH045649000,KAMMURI,2019,393,362,755
3776,PH174001000,KAMMURI,2019,152,7041,7193
3777,PH045605000,KAMMURI,2019,216,776,992
3778,PH174003000,KAMMURI,2019,229,2549,2778
3779,PH174004000,KAMMURI,2019,119,438,557
3780,PH012924000,KAMMURI,2019,214,1386,1600
3781,PH174006000,KAMMURI,2019,151,5883,6034
3782,PH175101000,KAMMURI,2019,452,685,1137
3783,PH175102000,KAMMURI,2019,115,705,820
3784,PH175103000,KAMMURI,2019,86,12,98
3785,PH175104000,KAMMURI,2019,814,0,814
3786,PH103511000,KAMMURI,2019,6,966,972
3787,PH175106000,KAMMURI,2019,77,0,77
3788,PH175107000,KAMMURI,2019,34,0,34
3789,PH021521000,KAMMURI,2019,111,611,722
3790,PH175109000,KAMMURI,2019,2050,0,2050
3791,PH184617000,KAMMURI,2019,40,0,40
3792,PH012924000,KAMMURI,2019,223,883,1106
3793,PH175201000,KAMMURI,2019,195,2206,2401
3794,PH175202000,KAMMURI,2019,578,3831,4409
3795,PH175203000,KAMMURI,2019,200,1375,1575
3796,PH175204000,KAMMURI,2019,25,15,40
3797,PH175205000,KAMMURI,2019,575,0,575
3798,PH175206000,KAMMURI,2019,1085,7912,8997
3799,PH175207000,KAMMURI,2019,84,0,84
3800,PH175208000,KAMMURI,2019,771,4176,4947
3801,PH175209000,KAMMURI,2019,1025,6964,7989
3802,PH175210000,KAMMURI,2019,498,344,842
3803,PH175211000,KAMMURI,2019,78,0,78
3804,PH023126000,KAMMURI,2019,5,113,118
3805,PH175213000,KAMMURI,2019,115,717,832
3806,PH166723000,KAMMURI,2019,340,3949,4289
3807,PH036917000,KAMMURI,2019,297,1262,1559
3808,PH072201000,KAMMURI,2019,37,162,199
3809,PH175902000,KAMMURI,2019,151,772,923
3810,PH175903000,KAMMURI,2019,308,718,1026
3811,PH184505000,KAMMURI,2019,183,1454,1637
3812,PH036905000,KAMMURI,2019,84,494,578
3813,PH175906000,KAMMURI,2019,130,2233,2363
3814,PH175916000,KAMMURI,2019,20,106,126
3815,PH175103000,KAMMURI,2019,17,265,282
3816,PH175908000,KAMMURI,2019,73,681,754
3817,PH175909000,KAMMURI,2019,31,495,526
3818,PH175910000,KAMMURI,2019,558,3722,4280
3819,PH023127000,KAMMURI,2019,321,1812,2133
3820,PH045640000,KAMMURI,2019,1290,1302,2592
3821,PH051732000,KAMMURI,2019,727,727,1454
3822,PH184617000,KAMMURI,2019,274,7,281
3823,PH025012000,KAMMURI,2019,134,151,285
3824,PH175917000,KAMMURI,2019,31,210,241
3825,PH050501000,KAMMURI,2019,500,7959,8459
3826,PH050502000,KAMMURI,2019,385,3326,3711
3827,PH050503000,KAMMURI,2019,595,6778,7373
3828,PH050504000,KAMMURI,2019,647,5799,6446
3829,PH050505000,KAMMURI,2019,68,2286,2354
3830,PH050506000,KAMMURI,2019,1195,7504,8699
3831,PH050507000,KAMMURI,2019,530,8452,8982
3832,PH050508000,KAMMURI,2019,436,6471,6907
3833,PH050509000,KAMMURI,2019,132,3323,3455
3834,PH050510000,KAMMURI,2019,112,5575,5687
3835,PH050511000,KAMMURI,2019,76,2465,2541
3836,PH050512000,KAMMURI,2019,807,8932,9739
3837,PH050513000,KAMMURI,2019,509,3826,4335
3838,PH050514000,KAMMURI,2019,509,7217,7726
3839,PH050515000,KAMMURI,2019,224,3711,3935
3840,PH050516000,KAMMURI,2019,144,3977,4121
3841,PH050517000,KAMMURI,2019,1188,10251,11439
3842,PH050518000,KAMMURI,2019,242,6648,6890
3843,PH051601000,KAMMURI,2019,44,518,562
3844,PH051602000,KAMMURI,2019,80,1944,2024
3845,PH051603000,KAMMURI,2019,111,643,754
3846,PH051605000,KAMMURI,2019,11,262,273
3847,PH051606000,KAMMURI,2019,147,1689,1836
3848,PH051607000,KAMMURI,2019,56,402,458
3849,PH051608000,KAMMURI,2019,386,1346,1732
3850,PH051604000,KAMMURI,2019,5,28,33
3851,PH012921000,KAMMURI,2019,0,128,128
3852,PH051610000,KAMMURI,2019,84,1048,1132
3853,PH041030000,KAMMURI,2019,89,545,634
3854,PH051612000,KAMMURI,2019,100,995,1095
3855,PH051701000,KAMMURI,2019,223,3199,3422
3856,PH051702000,KAMMURI,2019,436,3760,4196
3857,PH051703000,KAMMURI,2019,428,4272,4700
3858,PH051704000,KAMMURI,2019,113,1672,1785
3859,PH051705000,KAMMURI,2019,949,7057,8006
3860,PH051706000,KAMMURI,2019,332,2040,2372
3861,PH051707000,KAMMURI,2019,174,1708,1882
3862,PH051708000,KAMMURI,2019,456,5664,6120
3863,PH051709000,KAMMURI,2019,61,1581,1642
3864,PH051710000,KAMMURI,2019,180,3010,3190
3865,PH051711000,KAMMURI,2019,86,3383,3469
3866,PH051712000,KAMMURI,2019,15,588,603
3867,PH051713000,KAMMURI,2019,47,907,954
3868,PH051714000,KAMMURI,2019,131,2550,2681
3869,PH051715000,KAMMURI,2019,147,3781,3928
3870,PH051716000,KAMMURI,2019,961,7785,8746
3871,PH051717000,KAMMURI,2019,17,270,287
3872,PH051718000,KAMMURI,2019,384,6457,6841
3873,PH051719000,KAMMURI,2019,43,916,959
3874,PH051720000,KAMMURI,2019,127,2035,2162
3875,PH051721000,KAMMURI,2019,112,2917,3029
3876,PH051722000,KAMMURI,2019,179,2300,2479
3877,PH051723000,KAMMURI,2019,1171,7391,8562
3878,PH098309000,KAMMURI,2019,419,18544,18963
3879,PH051725000,KAMMURI,2019,452,7827,8279
3880,PH184616000,KAMMURI,2019,170,3302,3472
3881,PH051727000,KAMMURI,2019,263,2078,2341
3882,PH051728000,KAMMURI,2019,798,7797,8595
3883,PH051729000,KAMMURI,2019,51,1279,1330
3884,PH051730000,KAMMURI,2019,42,7,49
3885,PH051732000,KAMMURI,2019,42,1347,1389
3886,PH184617000,KAMMURI,2019,74,4068,4142
3887,PH051734000,KAMMURI,2019,136,1382,1518
3888,PH051735000,KAMMURI,2019,47,783,830
3889,PH051736000,KAMMURI,2019,413,6514,6927
3890,PH051737000,KAMMURI,2019,308,4401,4709
3891,PH052001000,KAMMURI,2019,802,162,964
3892,PH045803000,KAMMURI,2019,1108,36,1144
3893,PH051703000,KAMMURI,2019,1490,436,1926
3894,PH052004000,KAMMURI,2019,345,43,388
3895,PH052005000,KAMMURI,2019,488,14,502
3896,PH052006000,KAMMURI,2019,492,19,511
3897,PH052007000,KAMMURI,2019,567,56,623
3898,PH052008000,KAMMURI,2019,407,28,435
3899,PH031421000,KAMMURI,2019,1086,27,1113
3900,PH052010000,KAMMURI,2019,353,14,367
3901,PH052011000,KAMMURI,2019,3597,271,3868
3902,PH054101000,KAMMURI,2019,2237,9807,12044
3903,PH054102000,KAMMURI,2019,58,210,268
3904,PH054103000,KAMMURI,2019,22,210,232
3905,PH054104000,KAMMURI,2019,144,332,476
3906,PH054105000,KAMMURI,2019,23,342,365
3907,PH054106000,KAMMURI,2019,99,625,724
3908,PH021511000,KAMMURI,2019,773,3721,4494
3909,PH054108000,KAMMURI,2019,39,197,236
3910,PH054109000,KAMMURI,2019,0,1394,1394
3911,PH054110000,KAMMURI,2019,293,2297,2590
3912,PH054111000,KAMMURI,2019,214,1981,2195
3913,PH054112000,KAMMURI,2019,239,1165,1404
3914,PH054113000,KAMMURI,2019,147,1135,1282
3915,PH054114000,KAMMURI,2019,1021,3163,4184
3916,PH054115000,KAMMURI,2019,79,190,269
3917,PH054116000,KAMMURI,2019,1,65,66
3918,PH054117000,KAMMURI,2019,77,51,128
3919,PH051732000,KAMMURI,2019,394,1446,1840
3920,PH015534000,KAMMURI,2019,637,2581,3218
3921,PH041026000,KAMMURI,2019,1384,5327,6711
3922,PH054121000,KAMMURI,2019,95,661,756
3923,PH056202000,KAMMURI,2019,205,2200,2405
3924,PH056203000,KAMMURI,2019,2984,11772,14756
3925,PH056204000,KAMMURI,2019,281,3868,4149
3926,PH037702000,KAMMURI,2019,325,3163,3488
3927,PH056206000,KAMMURI,2019,876,1644,2520
3928,PH056207000,KAMMURI,2019,1280,5955,7235
3929,PH056208000,KAMMURI,2019,651,6593,7244
3930,PH056209000,KAMMURI,2019,879,4060,4939
3931,PH056210000,KAMMURI,2019,393,3069,3462
3932,PH042112000,KAMMURI,2019,789,2966,3755
3933,PH056212000,KAMMURI,2019,1387,5805,7192
3934,PH030811000,KAMMURI,2019,1840,7160,9000
3935,PH056214000,KAMMURI,2019,589,3381,3970
3936,PH056215000,KAMMURI,2019,251,1799,2050
3937,PH056216000,KAMMURI,2019,2439,12716,15155
3938,PH082605000,KAMMURI,2019,2,50,52
3939,PH082611000,KAMMURI,2019,14,1547,1561
3940,PH082614000,KAMMURI,2019,7,670,677
3941,PH084801000,KAMMURI,2019,967,5568,6535
3942,PH084802000,KAMMURI,2019,356,2134,2490
3943,PH084803000,KAMMURI,2019,568,5696,6264
3944,PH084804000,KAMMURI,2019,519,2489,3008
3945,PH084805000,KAMMURI,2019,946,19501,20447
3946,PH084811000,KAMMURI,2019,775,5494,6269
3947,PH084824000,KAMMURI,2019,114,1821,1935
3948,PH084813000,KAMMURI,2019,669,8417,9086
3949,PH013313000,KAMMURI,2019,250,2416,2666
3950,PH034924000,KAMMURI,2019,196,1469,1665
3951,PH023129000,KAMMURI,2019,394,5075,5469
3952,PH184617000,KAMMURI,2019,554,3830,4384
3953,PH012921000,KAMMURI,2019,55,1070,1125
3954,PH036917000,KAMMURI,2019,349,3077,3426
3955,PH084806000,KAMMURI,2019,143,7264,7407
3956,PH084807000,KAMMURI,2019,210,4276,4486
3957,PH084808000,KAMMURI,2019,2101,12220,14321
3958,PH084809000,KAMMURI,2019,53,2609,2662
3959,PH084810000,KAMMURI,2019,237,5287,5524
3960,PH084812000,KAMMURI,2019,73,922,995
3961,PH084814000,KAMMURI,2019,200,8037,8237
3962,PH084815000,KAMMURI,2019,450,6689,7139
3963,PH084820000,KAMMURI,2019,731,5140,5871
3964,PH084822000,KAMMURI,2019,511,1017,1528
3965,PH086001000,KAMMURI,2019,0,309,309
3966,PH086007000,KAMMURI,2019,17,78,95
3967,PH086011000,KAMMURI,2019,114,1212,1326
3968,PH086026000,KAMMURI,2019,34,829,863
3969,PH086025000,KAMMURI,2019,85,3246,3331
3970,PH086016000,KAMMURI,2019,135,1414,1549
3971,PH086024000,KAMMURI,2019,11,324,335
3972,PH086020000,KAMMURI,2019,33,1003,1036
3973,PH086005000,KAMMURI,2019,3,25,28
3974,PH086006000,KAMMURI,2019,0,352,352
3975,PH086009000,KAMMURI,2019,1,4,5
3976,PH086012000,KAMMURI,2019,6,857,863
3977,PH086013000,KAMMURI,2019,0,4,4
3978,PH166819000,KAMMURI,2019,3,9,12
3979,PH144402000,KAMMURI,2019,0,1,1
3980,PH031414000,VONGFONG,2020,2,1,3
3981,PH031420000,VONGFONG,2020,1,1,2
3982,PH082601000,VONGFONG,2020,1416,2654,4070
3983,PH082605000,VONGFONG,2020,63,2889,2952
3984,PH082611000,VONGFONG,2020,321,1808,2129
3985,PH082614000,VONGFONG,2020,104,476,580
3986,PH082617000,VONGFONG,2020,173,615,788
3987,PH082621000,VONGFONG,2020,889,2650,3539
3988,PH082622000,VONGFONG,2020,0,3,3
3989,PH084801000,VONGFONG,2020,84,740,824
3990,PH084802000,VONGFONG,2020,1,162,163
3991,PH084803000,VONGFONG,2020,22,1857,1879
3992,PH084804000,VONGFONG,2020,5,189,194
3993,PH084805000,VONGFONG,2020,608,8377,8985
3994,PH084811000,VONGFONG,2020,72,550,622
3995,PH084824000,VONGFONG,2020,15,1255,1270
3996,PH084813000,VONGFONG,2020,5,193,198
3997,PH013313000,VONGFONG,2020,114,1377,1491
3998,PH034924000,VONGFONG,2020,5,204,209
3999,PH023129000,VONGFONG,2020,13,386,399
4000,PH184617000,VONGFONG,2020,63,3095,3158
4001,PH012921000,VONGFONG,2020,2,257,259
4002,PH036917000,VONGFONG,2020,16,1277,1293
4003,PH084806000,VONGFONG,2020,363,7331,7694
4004,PH084807000,VONGFONG,2020,1067,4192,5259
4005,PH084808000,VONGFONG,2020,48,357,405
4006,PH084809000,VONGFONG,2020,1832,1964,3796
4007,PH084810000,VONGFONG,2020,190,2720,2910
4008,PH084812000,VONGFONG,2020,22,366,388
4009,PH084814000,VONGFONG,2020,13,386,399
4010,PH084815000,VONGFONG,2020,1,0,1
4011,PH084820000,VONGFONG,2020,84,456,540
4012,PH084822000,VONGFONG,2020,441,2080,2521
4013,PH086011000,VONGFONG,2020,2,4,6
4014,PH086025000,VONGFONG,2020,16,1336,1352
4015,PH086024000,VONGFONG,2020,0,13,13
4016,PH045616000,SAUDEL,2020,1,1,2
4017,PH045622000,SAUDEL,2020,3,3,6
4018,PH041006000,MOLAVE,2020,40,143,183
4019,PH041007000,MOLAVE,2020,3,46,49
4020,PH041014000,MOLAVE,2020,1,27,28
4021,PH041015000,MOLAVE,2020,59,518,577
4022,PH041026000,MOLAVE,2020,0,5,5
4023,PH021525000,MOLAVE,2020,3,99,102
4024,PH041032000,MOLAVE,2020,22,70,92
4025,PH041033000,MOLAVE,2020,93,1432,1525
4026,PH042111000,MOLAVE,2020,2,0,2
4027,PH042112000,MOLAVE,2020,3,6,9
4028,PH042115000,MOLAVE,2020,2,0,2
4029,PH043405000,MOLAVE,2020,0,14,14
4030,PH043407000,MOLAVE,2020,0,1,1
4031,PH043426000,MOLAVE,2020,0,2,2
4032,PH045601000,MOLAVE,2020,0,4,4
4033,PH045603000,MOLAVE,2020,0,27,27
4034,PH037103000,MOLAVE,2020,1,35,36
4035,PH045610000,MOLAVE,2020,28,920,948
4036,PH045615000,MOLAVE,2020,7,668,675
4037,PH045616000,MOLAVE,2020,2,89,91
4038,PH045619000,MOLAVE,2020,2,58,60
4039,PH045623000,MOLAVE,2020,1,6,7
4040,PH045627000,MOLAVE,2020,4,15,19
4041,PH045628000,MOLAVE,2020,51,635,686
4042,PH045629000,MOLAVE,2020,1,8,9
4043,PH045630000,MOLAVE,2020,3,2,5
4044,PH045631000,MOLAVE,2020,0,11,11
4045,PH045634000,MOLAVE,2020,0,55,55
4046,PH034924000,MOLAVE,2020,2,47,49
4047,PH045642000,MOLAVE,2020,443,2266,2709
4048,PH045645000,MOLAVE,2020,9,163,172
4049,PH045647000,MOLAVE,2020,6,55,61
4050,PH045648000,MOLAVE,2020,4,125,129
4051,PH174001000,MOLAVE,2020,110,2796,2906
4052,PH045605000,MOLAVE,2020,128,1117,1245
4053,PH174003000,MOLAVE,2020,104,1361,1465
4054,PH174004000,MOLAVE,2020,110,1929,2039
4055,PH012924000,MOLAVE,2020,235,4041,4276
4056,PH174006000,MOLAVE,2020,66,2144,2210
4057,PH175101000,MOLAVE,2020,21,461,482
4058,PH175104000,MOLAVE,2020,8,649,657
4059,PH103511000,MOLAVE,2020,0,2,2
4060,PH021521000,MOLAVE,2020,13,6,19
4061,PH175109000,MOLAVE,2020,41,999,1040
4062,PH184617000,MOLAVE,2020,14,109,123
4063,PH012924000,MOLAVE,2020,1593,3600,5193
4064,PH175201000,MOLAVE,2020,92,1932,2024
4065,PH175202000,MOLAVE,2020,15,85,100
4066,PH175203000,MOLAVE,2020,44,263,307
4067,PH175204000,MOLAVE,2020,57,220,277
4068,PH175205000,MOLAVE,2020,425,5441,5866
4069,PH175206000,MOLAVE,2020,797,3183,3980
4070,PH175207000,MOLAVE,2020,7,40,47
4071,PH175208000,MOLAVE,2020,727,4813,5540
4072,PH175209000,MOLAVE,2020,1021,8701,9722
4073,PH175210000,MOLAVE,2020,637,995,1632
4074,PH175211000,MOLAVE,2020,208,1316,1524
4075,PH023126000,MOLAVE,2020,9,149,158
4076,PH175213000,MOLAVE,2020,110,73,183
4077,PH166723000,MOLAVE,2020,138,2999,3137
4078,PH036917000,MOLAVE,2020,163,3181,3344
4079,PH175902000,MOLAVE,2020,12,98,110
4080,PH036905000,MOLAVE,2020,3,231,234
4081,PH175916000,MOLAVE,2020,0,12,12
4082,PH175103000,MOLAVE,2020,1,54,55
4083,PH045640000,MOLAVE,2020,1,29,30
4084,PH050501000,MOLAVE,2020,20,447,467
4085,PH050502000,MOLAVE,2020,13,685,698
4086,PH050503000,MOLAVE,2020,4,1,5
4087,PH050504000,MOLAVE,2020,11,339,350
4088,PH050505000,MOLAVE,2020,9,278,287
4089,PH050506000,MOLAVE,2020,13,304,317
4090,PH050507000,MOLAVE,2020,12,291,303
4091,PH050508000,MOLAVE,2020,11,259,270
4092,PH050509000,MOLAVE,2020,41,149,190
4093,PH050510000,MOLAVE,2020,101,957,1058
4094,PH050511000,MOLAVE,2020,27,491,518
4095,PH050512000,MOLAVE,2020,31,1057,1088
4096,PH050513000,MOLAVE,2020,116,741,857
4097,PH050514000,MOLAVE,2020,88,843,931
4098,PH050515000,MOLAVE,2020,14,611,625
4099,PH050516000,MOLAVE,2020,32,985,1017
4100,PH050517000,MOLAVE,2020,98,2970,3068
4101,PH050518000,MOLAVE,2020,24,1362,1386
4102,PH051601000,MOLAVE,2020,0,9,9
4103,PH051701000,MOLAVE,2020,42,635,677
4104,PH051703000,MOLAVE,2020,10,77,87
4105,PH051705000,MOLAVE,2020,36,649,685
4106,PH051706000,MOLAVE,2020,10,283,293
4107,PH051707000,MOLAVE,2020,3,77,80
4108,PH051708000,MOLAVE,2020,16,301,317
4109,PH051709000,MOLAVE,2020,3,76,79
4110,PH051710000,MOLAVE,2020,7,678,685
4111,PH051711000,MOLAVE,2020,5,60,65
4112,PH051713000,MOLAVE,2020,3,1,4
4113,PH051715000,MOLAVE,2020,24,1816,1840
4114,PH051717000,MOLAVE,2020,0,7,7
4115,PH051718000,MOLAVE,2020,39,1246,1285
4116,PH051719000,MOLAVE,2020,1,40,41
4117,PH051720000,MOLAVE,2020,8,44,52
4118,PH051721000,MOLAVE,2020,1,64,65
4119,PH051722000,MOLAVE,2020,20,6,26
4120,PH051723000,MOLAVE,2020,12,333,345
4121,PH098309000,MOLAVE,2020,12,754,766
4122,PH051727000,MOLAVE,2020,44,685,729
4123,PH051728000,MOLAVE,2020,79,1867,1946
4124,PH051729000,MOLAVE,2020,9,360,369
4125,PH051730000,MOLAVE,2020,1,1,2
4126,PH051731000,MOLAVE,2020,88,725,813
4127,PH051732000,MOLAVE,2020,8,126,134
4128,PH184617000,MOLAVE,2020,64,904,968
4129,PH051734000,MOLAVE,2020,1,116,117
4130,PH051735000,MOLAVE,2020,0,23,23
4131,PH051737000,MOLAVE,2020,5,555,560
4132,PH052001000,MOLAVE,2020,26,552,578
4133,PH045803000,MOLAVE,2020,108,1083,1191
4134,PH052004000,MOLAVE,2020,13,77,90
4135,PH052006000,MOLAVE,2020,6,0,6
4136,PH031421000,MOLAVE,2020,42,847,889
4137,PH052010000,MOLAVE,2020,117,2,119
4138,PH054106000,MOLAVE,2020,0,2,2
4139,PH021511000,MOLAVE,2020,0,3,3
4140,PH041026000,MOLAVE,2020,188,1508,1696
4141,PH037702000,MOLAVE,2020,0,74,74
4142,PH056207000,MOLAVE,2020,8,211,219
4143,PH056214000,MOLAVE,2020,0,40,40
4144,PH060616000,MOLAVE,2020,0,1,1
4145,PH060607000,MOLAVE,2020,1,0,1
4146,PH060606000,MOLAVE,2020,3,50,53
4147,PH060612000,MOLAVE,2020,0,3,3
4148,PH060617000,MOLAVE,2020,1,0,1
4149,PH063002000,MOLAVE,2020,1,9,10
4150,PH063023000,MOLAVE,2020,3,5,8
4151,PH063030000,MOLAVE,2020,2,2,4
4152,PH063037000,MOLAVE,2020,1,7,8
4153,PH184512000,MOLAVE,2020,3,42,45
4154,PH184606000,MOLAVE,2020,6,1,7
4155,PH087801000,MOLAVE,2020,2,0,2
4156,PH041001000,GONI,2020,0,13,13
4157,PH041002000,GONI,2020,1,115,116
4158,PH041003000,GONI,2020,0,11,11
4159,PH041004000,GONI,2020,0,5,5
4160,PH041005000,GONI,2020,410,4797,5207
4161,PH041006000,GONI,2020,7,67,74
4162,PH041008000,GONI,2020,2,18,20
4163,PH041009000,GONI,2020,0,16,16
4164,PH041012000,GONI,2020,2,2,4
4165,PH041013000,GONI,2020,0,75,75
4166,PH041014000,GONI,2020,0,167,167
4167,PH041015000,GONI,2020,0,5,5
4168,PH015523000,GONI,2020,7,150,157
4169,PH041018000,GONI,2020,0,11,11
4170,PH041019000,GONI,2020,0,15,15
4171,PH041020000,GONI,2020,0,66,66
4172,PH013313000,GONI,2020,0,67,67
4173,PH184617000,GONI,2020,3,34,37
4174,PH013316000,GONI,2020,1,80,81
4175,PH041026000,GONI,2020,0,8,8
4176,PH021525000,GONI,2020,0,3,3
4177,PH041029000,GONI,2020,0,27,27
4178,PH041030000,GONI,2020,3,157,160
4179,PH041031000,GONI,2020,8,165,173
4180,PH042116000,GONI,2020,0,1,1
4181,PH043401000,GONI,2020,1,87,88
4182,PH043418000,GONI,2020,1,27,28
4183,PH043424000,GONI,2020,26,109,135
4184,PH043426000,GONI,2020,1,22,23
4185,PH043428000,GONI,2020,3,0,3
4186,PH045601000,GONI,2020,7,187,194
4187,PH045602000,GONI,2020,0,35,35
4188,PH045603000,GONI,2020,15,659,674
4189,PH045605000,GONI,2020,118,3066,3184
4190,PH045606000,GONI,2020,0,1,1
4191,PH045607000,GONI,2020,54,224,278
4192,PH037103000,GONI,2020,0,16,16
4193,PH045610000,GONI,2020,80,1412,1492
4194,PH045615000,GONI,2020,15,129,144
4195,PH045616000,GONI,2020,38,517,555
4196,PH045619000,GONI,2020,37,626,663
4197,PH045622000,GONI,2020,110,1458,1568
4198,PH045623000,GONI,2020,0,6,6
4199,PH050506000,GONI,2020,1,17,18
4200,PH045625000,GONI,2020,17,751,768
4201,PH045627000,GONI,2020,7,179,186
4202,PH045628000,GONI,2020,251,3595,3846
4203,PH045629000,GONI,2020,22,239,261
4204,PH045630000,GONI,2020,4,73,77
4205,PH045634000,GONI,2020,27,562,589
4206,PH031417000,GONI,2020,0,87,87
4207,PH045636000,GONI,2020,3,7,10
4208,PH023122000,GONI,2020,10,54,64
4209,PH045638000,GONI,2020,83,296,379
4210,PH045640000,GONI,2020,140,2327,2467
4211,PH034924000,GONI,2020,2,87,89
4212,PH045642000,GONI,2020,333,2464,2797
4213,PH045645000,GONI,2020,10,88,98
4214,PH045646000,GONI,2020,421,1763,2184
4215,PH045647000,GONI,2020,9,287,296
4216,PH045648000,GONI,2020,12,251,263
4217,PH045649000,GONI,2020,1,56,57
4218,PH174001000,GONI,2020,9,291,300
4219,PH045605000,GONI,2020,9,53,62
4220,PH174003000,GONI,2020,12,160,172
4221,PH174004000,GONI,2020,59,151,210
4222,PH012924000,GONI,2020,1,7,8
4223,PH174006000,GONI,2020,3,47,50
4224,PH175203000,GONI,2020,0,2,2
4225,PH050501000,GONI,2020,2022,9294,11316
4226,PH050502000,GONI,2020,259,2178,2437
4227,PH050503000,GONI,2020,351,2901,3252
4228,PH050504000,GONI,2020,885,3780,4665
4229,PH050505000,GONI,2020,73,872,945
4230,PH050506000,GONI,2020,375,5619,5994
4231,PH050507000,GONI,2020,1191,8022,9213
4232,PH050508000,GONI,2020,1237,6255,7492
4233,PH050509000,GONI,2020,1843,4907,6750
4234,PH050510000,GONI,2020,3359,7203,10562
4235,PH050511000,GONI,2020,167,1524,1691
4236,PH050512000,GONI,2020,799,7298,8097
4237,PH050513000,GONI,2020,360,1628,1988
4238,PH050514000,GONI,2020,2297,8614,10911
4239,PH050515000,GONI,2020,279,2435,2714
4240,PH050516000,GONI,2020,330,2830,3160
4241,PH050517000,GONI,2020,5890,17964,23854
4242,PH050518000,GONI,2020,2291,9669,11960
4243,PH051601000,GONI,2020,256,1184,1440
4244,PH051602000,GONI,2020,4,124,128
4245,PH051603000,GONI,2020,83,871,954
4246,PH051605000,GONI,2020,42,112,154
4247,PH051606000,GONI,2020,47,462,509
4248,PH051607000,GONI,2020,93,1176,1269
4249,PH051608000,GONI,2020,115,151,266
4250,PH051604000,GONI,2020,6,55,61
4251,PH012921000,GONI,2020,22,289,311
4252,PH041030000,GONI,2020,124,532,656
4253,PH051612000,GONI,2020,42,427,469
4254,PH051701000,GONI,2020,612,4493,5105
4255,PH051702000,GONI,2020,435,3181,3616
4256,PH051703000,GONI,2020,908,5002,5910
4257,PH051704000,GONI,2020,276,2122,2398
4258,PH051705000,GONI,2020,2662,7169,9831
4259,PH051706000,GONI,2020,1881,11197,13078
4260,PH051707000,GONI,2020,295,1931,2226
4261,PH051708000,GONI,2020,1501,7513,9014
4262,PH051709000,GONI,2020,287,3018,3305
4263,PH051710000,GONI,2020,722,3812,4534
4264,PH051711000,GONI,2020,573,4046,4619
4265,PH051712000,GONI,2020,94,1209,1303
4266,PH051713000,GONI,2020,183,1287,1470
4267,PH051714000,GONI,2020,511,2494,3005
4268,PH051715000,GONI,2020,719,7360,8079
4269,PH051716000,GONI,2020,1218,7834,9052
4270,PH051717000,GONI,2020,242,3477,3719
4271,PH051718000,GONI,2020,269,2566,2835
4272,PH051719000,GONI,2020,150,1707,1857
4273,PH051720000,GONI,2020,511,2494,3005
4274,PH051722000,GONI,2020,1026,0,1026
4275,PH051723000,GONI,2020,2177,7566,9743
4276,PH098309000,GONI,2020,1413,12282,13695
4277,PH051725000,GONI,2020,853,5399,6252
4278,PH184616000,GONI,2020,958,4734,5692
4279,PH051727000,GONI,2020,1160,5408,6568
4280,PH051728000,GONI,2020,853,5399,6252
4281,PH051729000,GONI,2020,458,2228,2686
4282,PH051730000,GONI,2020,233,1745,1978
4283,PH051731000,GONI,2020,996,6675,7671
4284,PH051732000,GONI,2020,482,3681,4163
4285,PH184617000,GONI,2020,984,4632,5616
4286,PH051734000,GONI,2020,162,1561,1723
4287,PH051735000,GONI,2020,42,271,313
4288,PH051736000,GONI,2020,1784,7673,9457
4289,PH051737000,GONI,2020,537,5748,6285
4290,PH052001000,GONI,2020,122,196,318
4291,PH045803000,GONI,2020,1972,1311,3283
4292,PH051703000,GONI,2020,2204,2848,5052
4293,PH052004000,GONI,2020,268,1765,2033
4294,PH052005000,GONI,2020,741,1458,2199
4295,PH052006000,GONI,2020,88,508,596
4296,PH052007000,GONI,2020,149,551,700
4297,PH052008000,GONI,2020,1045,1404,2449
4298,PH031421000,GONI,2020,1210,2450,3660
4299,PH052010000,GONI,2020,475,2305,2780
4300,PH052011000,GONI,2020,5262,8718,13980
4301,PH021511000,GONI,2020,0,2,2
4302,PH041026000,GONI,2020,188,1508,1696
4303,PH056202000,GONI,2020,45,0,45
4304,PH056204000,GONI,2020,0,25,25
4305,PH037702000,GONI,2020,111,2,113
4306,PH056206000,GONI,2020,25,313,338
4307,PH056207000,GONI,2020,60,1307,1367
4308,PH056208000,GONI,2020,0,8,8
4309,PH056210000,GONI,2020,3,48,51
4310,PH042112000,GONI,2020,9,113,122
4311,PH030811000,GONI,2020,82,1205,1287
4312,PH056214000,GONI,2020,4,342,346
4313,PH056216000,GONI,2020,108,4426,4534
4314,PH148104000,GONI,2020,0,2,2
4315,PH012815000,VAMCO,2020,0,11,11
4316,PH013310000,VAMCO,2020,1,10,11
4317,PH015504000,VAMCO,2020,0,5,5
4318,PH015507000,VAMCO,2020,2,93,95
4319,PH015508000,VAMCO,2020,0,2,2
4320,PH015509000,VAMCO,2020,12,101,113
4321,PH015510000,VAMCO,2020,13,185,198
4322,PH015511000,VAMCO,2020,13,303,316
4323,PH015512000,VAMCO,2020,0,4,4
4324,PH015517000,VAMCO,2020,0,7,7
4325,PH015520000,VAMCO,2020,7,22,29
4326,PH015521000,VAMCO,2020,0,1,1
4327,PH015548000,VAMCO,2020,0,3,3
4328,PH015522000,VAMCO,2020,4,1,5
4329,PH015523000,VAMCO,2020,3,65,68
4330,PH015524000,VAMCO,2020,0,1,1
4331,PH015527000,VAMCO,2020,18,660,678
4332,PH015531000,VAMCO,2020,1,5,6
4333,PH015535000,VAMCO,2020,1,10,11
4334,PH015537000,VAMCO,2020,2,44,46
4335,PH015543000,VAMCO,2020,0,1,1
4336,PH015545000,VAMCO,2020,40,1294,1334
4337,PH015546000,VAMCO,2020,1,8,9
4338,PH015547000,VAMCO,2020,0,1,1
4339,PH015504000,VAMCO,2020,37,95,132
4340,PH021504000,VAMCO,2020,52,131,183
4341,PH021506000,VAMCO,2020,19,17,36
4342,PH021512000,VAMCO,2020,2,148,150
4343,PH021513000,VAMCO,2020,3,3,6
4344,PH021527000,VAMCO,2020,2,148,150
4345,PH021529000,VAMCO,2020,29,25,54
4346,PH023101000,VAMCO,2020,2,0,2
4347,PH023106000,VAMCO,2020,5,16,21
4348,PH023108000,VAMCO,2020,12,0,12
4349,PH023118000,VAMCO,2020,0,3,3
4350,PH023112000,VAMCO,2020,0,2,2
4351,PH023114000,VAMCO,2020,7,60,67
4352,PH023115000,VAMCO,2020,5,0,5
4353,PH023131000,VAMCO,2020,12,6,18
4354,PH012926000,VAMCO,2020,2,39,41
4355,PH013317000,VAMCO,2020,21,38,59
4356,PH023137000,VAMCO,2020,2,2,4
4357,PH025015000,VAMCO,2020,5,102,107
4358,PH025001000,VAMCO,2020,3,47,50
4359,PH025002000,VAMCO,2020,1,104,105
4360,PH025004000,VAMCO,2020,6,38,44
4361,PH025005000,VAMCO,2020,2,14,16
4362,PH025006000,VAMCO,2020,2,0,2
4363,PH025007000,VAMCO,2020,3,2,5
4364,PH025008000,VAMCO,2020,0,4,4
4365,PH025009000,VAMCO,2020,1,7,8
4366,PH025010000,VAMCO,2020,0,59,59
4367,PH025012000,VAMCO,2020,2,94,96
4368,PH025014000,VAMCO,2020,2,0,2
4369,PH025702000,VAMCO,2020,3,10,13
4370,PH025703000,VAMCO,2020,1,0,1
4371,PH025704000,VAMCO,2020,7,2,9
4372,PH025706000,VAMCO,2020,96,2,98
4373,PH037701000,VAMCO,2020,115,3290,3405
4374,PH037702000,VAMCO,2020,3,2,5
4375,PH037703000,VAMCO,2020,3,106,109
4376,PH037704000,VAMCO,2020,9,42,51
4377,PH037705000,VAMCO,2020,196,1019,1215
4378,PH037706000,VAMCO,2020,33,106,139
4379,PH037707000,VAMCO,2020,38,166,204
4380,PH035417000,VAMCO,2020,122,691,813
4381,PH030801000,VAMCO,2020,0,1,1
4382,PH030803000,VAMCO,2020,0,1,1
4383,PH030804000,VAMCO,2020,0,15,15
4384,PH030805000,VAMCO,2020,4,47,51
4385,PH030806000,VAMCO,2020,1,4,5
4386,PH030807000,VAMCO,2020,0,2,2
4387,PH030808000,VAMCO,2020,3,28,31
4388,PH030809000,VAMCO,2020,0,9,9
4389,PH030810000,VAMCO,2020,3,6,9
4390,PH030812000,VAMCO,2020,4,52,56
4391,PH031401000,VAMCO,2020,202,1239,1441
4392,PH031402000,VAMCO,2020,3,83,86
4393,PH031403000,VAMCO,2020,321,1178,1499
4394,PH031404000,VAMCO,2020,50,406,456
4395,PH031405000,VAMCO,2020,12,214,226
4396,PH031406000,VAMCO,2020,261,1275,1536
4397,PH031407000,VAMCO,2020,8,546,554
4398,PH031424000,VAMCO,2020,291,2415,2706
4399,PH031408000,VAMCO,2020,118,649,767
4400,PH031409000,VAMCO,2020,118,649,767
4401,PH031410000,VAMCO,2020,28,596,624
4402,PH031411000,VAMCO,2020,26,40,66
4403,PH031412000,VAMCO,2020,37,219,256
4404,PH031413000,VAMCO,2020,189,2087,2276
4405,PH031414000,VAMCO,2020,15,105,120
4406,PH031415000,VAMCO,2020,43,182,225
4407,PH031416000,VAMCO,2020,2,55,57
4408,PH031417000,VAMCO,2020,50,643,693
4409,PH031418000,VAMCO,2020,25,388,413
4410,PH012919000,VAMCO,2020,536,4286,4822
4411,PH031420000,VAMCO,2020,5,90,95
4412,PH031421000,VAMCO,2020,1154,9772,10926
4413,PH031422000,VAMCO,2020,28,1368,1396
4414,PH012926000,VAMCO,2020,173,609,782
4415,PH034901000,VAMCO,2020,47,603,650
4416,PH034902000,VAMCO,2020,58,512,570
4417,PH034903000,VAMCO,2020,104,1992,2096
4418,PH034904000,VAMCO,2020,155,1305,1460
4419,PH034905000,VAMCO,2020,4,25,29
4420,PH034908000,VAMCO,2020,271,1320,1591
4421,PH034906000,VAMCO,2020,0,32,32
4422,PH034907000,VAMCO,2020,333,836,1169
4423,PH034909000,VAMCO,2020,47,209,256
4424,PH034910000,VAMCO,2020,5,441,446
4425,PH034911000,VAMCO,2020,2,212,214
4426,PH034912000,VAMCO,2020,101,1861,1962
4427,PH034913000,VAMCO,2020,51,240,291
4428,PH034914000,VAMCO,2020,34,671,705
4429,PH034915000,VAMCO,2020,40,356,396
4430,PH034916000,VAMCO,2020,2,39,41
4431,PH061914000,VAMCO,2020,52,510,562
4432,PH034920000,VAMCO,2020,3,122,125
4433,PH023122000,VAMCO,2020,22,192,214
4434,PH021521000,VAMCO,2020,31,604,635
4435,PH034924000,VAMCO,2020,143,1320,1463
4436,PH023129000,VAMCO,2020,70,870,940
4437,PH034926000,VAMCO,2020,6,176,182
4438,PH034927000,VAMCO,2020,11,1056,1067
4439,PH034928000,VAMCO,2020,165,957,1122
4440,PH012928000,VAMCO,2020,0,165,165
4441,PH034917000,VAMCO,2020,0,26,26
4442,PH034930000,VAMCO,2020,12,733,745
4443,PH034932000,VAMCO,2020,60,878,938
4444,PH035402000,VAMCO,2020,5,445,450
4445,PH035403000,VAMCO,2020,0,4678,4678
4446,PH035404000,VAMCO,2020,0,9,9
4447,PH035405000,VAMCO,2020,392,3913,4305
4448,PH035406000,VAMCO,2020,6,17,23
4449,PH035407000,VAMCO,2020,0,13,13
4450,PH035408000,VAMCO,2020,14,44,58
4451,PH035410000,VAMCO,2020,6,119,125
4452,PH035411000,VAMCO,2020,5,0,5
4453,PH035412000,VAMCO,2020,64,9,73
4454,PH035413000,VAMCO,2020,103,11,114
4455,PH035414000,VAMCO,2020,0,34,34
4456,PH035415000,VAMCO,2020,1,202,203
4457,PH013314000,VAMCO,2020,1,35,36
4458,PH035417000,VAMCO,2020,41,704,745
4459,PH035418000,VAMCO,2020,24,309,333
4460,PH021523000,VAMCO,2020,29,364,393
4461,PH035420000,VAMCO,2020,1,22,23
4462,PH035422000,VAMCO,2020,0,110,110
4463,PH036901000,VAMCO,2020,0,45,45
4464,PH036902000,VAMCO,2020,24,159,183
4465,PH036903000,VAMCO,2020,31,669,700
4466,PH036904000,VAMCO,2020,79,1435,1514
4467,PH036905000,VAMCO,2020,36,113,149
4468,PH036906000,VAMCO,2020,96,916,1012
4469,PH036907000,VAMCO,2020,42,295,337
4470,PH036908000,VAMCO,2020,7,60,67
4471,PH036909000,VAMCO,2020,4,103,107
4472,PH036910000,VAMCO,2020,9,166,175
4473,PH036911000,VAMCO,2020,6,401,407
4474,PH036912000,VAMCO,2020,12,488,500
4475,PH036913000,VAMCO,2020,11,90,101
4476,PH184617000,VAMCO,2020,8,122,130
4477,PH015535000,VAMCO,2020,0,95,95
4478,PH036915000,VAMCO,2020,30,366,396
4479,PH036916000,VAMCO,2020,91,459,550
4480,PH036917000,VAMCO,2020,180,1040,1220
4481,PH037101000,VAMCO,2020,5,129,134
4482,PH037102000,VAMCO,2020,0,4,4
4483,PH037103000,VAMCO,2020,0,53,53
4484,PH037105000,VAMCO,2020,5,101,106
4485,PH037111000,VAMCO,2020,0,7,7
4486,PH037112000,VAMCO,2020,0,4,4
4487,PH012924000,VAMCO,2020,5,113,118
4488,PH037114000,VAMCO,2020,0,6,6
4489,PH041006000,VAMCO,2020,0,8,8
4490,PH041009000,VAMCO,2020,0,10,10
4491,PH041011000,VAMCO,2020,2,51,53
4492,PH041019000,VAMCO,2020,2,20,22
4493,PH035417000,VAMCO,2020,0,3,3
4494,PH041026000,VAMCO,2020,0,1,1
4495,PH041030000,VAMCO,2020,0,17,17
4496,PH041031000,VAMCO,2020,3,81,84
4497,PH041032000,VAMCO,2020,0,1,1
4498,PH043402000,VAMCO,2020,2,70,72
4499,PH043405000,VAMCO,2020,155,523,678
4500,PH043418000,VAMCO,2020,4,56,60
4501,PH043421000,VAMCO,2020,5,12,17
4502,PH043426000,VAMCO,2020,13,145,158
4503,PH043429000,VAMCO,2020,28,719,747
4504,PH036917000,VAMCO,2020,0,8,8
4505,PH045601000,VAMCO,2020,0,5,5
4506,PH045602000,VAMCO,2020,2,26,28
4507,PH045603000,VAMCO,2020,0,33,33
4508,PH045605000,VAMCO,2020,38,686,724
4509,PH045606000,VAMCO,2020,227,895,1122
4510,PH037103000,VAMCO,2020,0,18,18
4511,PH045610000,VAMCO,2020,126,2043,2169
4512,PH045616000,VAMCO,2020,14,139,153
4513,PH045617000,VAMCO,2020,264,1429,1693
4514,PH045619000,VAMCO,2020,0,93,93
4515,PH015520000,VAMCO,2020,677,5623,6300
4516,PH045621000,VAMCO,2020,90,564,654
4517,PH045622000,VAMCO,2020,31,278,309
4518,PH045623000,VAMCO,2020,0,5,5
4519,PH045625000,VAMCO,2020,3,112,115
4520,PH045627000,VAMCO,2020,1,79,80
4521,PH045628000,VAMCO,2020,0,13,13
4522,PH045629000,VAMCO,2020,0,26,26
4523,PH045630000,VAMCO,2020,6,0,6
4524,PH045631000,VAMCO,2020,181,2422,2603
4525,PH045632000,VAMCO,2020,404,2614,3018
4526,PH045633000,VAMCO,2020,3,40,43
4527,PH045634000,VAMCO,2020,0,82,82
4528,PH031417000,VAMCO,2020,2,16,18
4529,PH045636000,VAMCO,2020,221,2682,2903
4530,PH045638000,VAMCO,2020,16,145,161
4531,PH045639000,VAMCO,2020,0,164,164
4532,PH034924000,VAMCO,2020,1,153,154
4533,PH045645000,VAMCO,2020,7,53,60
4534,PH045647000,VAMCO,2020,5,33,38
4535,PH045648000,VAMCO,2020,7,84,91
4536,PH045802000,VAMCO,2020,1,81,82
4537,PH045803000,VAMCO,2020,35,233,268
4538,PH045804000,VAMCO,2020,58,476,534
4539,PH045805000,VAMCO,2020,0,63,63
4540,PH045806000,VAMCO,2020,30,546,576
4541,PH030808000,VAMCO,2020,3,7,10
4542,PH045808000,VAMCO,2020,1467,1661,3128
4543,PH045812000,VAMCO,2020,214,664,878
4544,PH050507000,VAMCO,2020,6,0,6
4545,PH050509000,VAMCO,2020,40,467,507
4546,PH050511000,VAMCO,2020,40,280,320
4547,PH050512000,VAMCO,2020,0,9,9
4548,PH051601000,VAMCO,2020,199,964,1163
4549,PH051602000,VAMCO,2020,117,2212,2329
4550,PH051603000,VAMCO,2020,632,3752,4384
4551,PH051605000,VAMCO,2020,626,3229,3855
4552,PH051606000,VAMCO,2020,565,4893,5458
4553,PH051607000,VAMCO,2020,347,2240,2587
4554,PH051608000,VAMCO,2020,632,4084,4716
4555,PH051604000,VAMCO,2020,26,248,274
4556,PH012921000,VAMCO,2020,83,799,882
4557,PH051610000,VAMCO,2020,125,935,1060
4558,PH041030000,VAMCO,2020,410,1973,2383
4559,PH051612000,VAMCO,2020,701,3601,4302
4560,PH051701000,VAMCO,2020,76,4032,4108
4561,PH051703000,VAMCO,2020,1220,0,1220
4562,PH051706000,VAMCO,2020,1546,0,1546
4563,PH051707000,VAMCO,2020,150,917,1067
4564,PH051708000,VAMCO,2020,358,2364,2722
4565,PH051709000,VAMCO,2020,0,11,11
4566,PH051710000,VAMCO,2020,82,550,632
4567,PH051711000,VAMCO,2020,335,4684,5019
4568,PH051712000,VAMCO,2020,4,93,97
4569,PH051713000,VAMCO,2020,2,29,31
4570,PH051714000,VAMCO,2020,58,877,935
4571,PH051715000,VAMCO,2020,449,4153,4602
4572,PH051717000,VAMCO,2020,161,2356,2517
4573,PH051718000,VAMCO,2020,269,3842,4111
4574,PH051719000,VAMCO,2020,51,424,475
4575,PH051721000,VAMCO,2020,34,298,332
4576,PH051725000,VAMCO,2020,446,4932,5378
4577,PH184616000,VAMCO,2020,638,2887,3525
4578,PH051727000,VAMCO,2020,193,360,553
4579,PH051728000,VAMCO,2020,290,1853,2143
4580,PH051729000,VAMCO,2020,355,2220,2575
4581,PH051730000,VAMCO,2020,112,1118,1230
4582,PH051732000,VAMCO,2020,54,483,537
4583,PH051734000,VAMCO,2020,111,1485,1596
4584,PH051735000,VAMCO,2020,379,1076,1455
4585,PH051736000,VAMCO,2020,1225,3307,4532
4586,PH051737000,VAMCO,2020,907,6290,7197
4587,PH041026000,VAMCO,2020,46,39,85
4588,PH056207000,VAMCO,2020,1,16,17
4589,PH030811000,VAMCO,2020,1,12,13
4590,PH140111000,VAMCO,2020,0,9,9
4591,PH140115000,VAMCO,2020,0,2,2
4592,PH141101000,VAMCO,2020,1,17,18
4593,PH141103000,VAMCO,2020,0,26,26
4594,PH141104000,VAMCO,2020,7,68,75
4595,PH141105000,VAMCO,2020,3,45,48
4596,PH141106000,VAMCO,2020,2,65,67
4597,PH141107000,VAMCO,2020,4,21,25
4598,PH141108000,VAMCO,2020,0,2,2
4599,PH141109000,VAMCO,2020,4,72,76
4600,PH141111000,VAMCO,2020,0,4,4
4601,PH141113000,VAMCO,2020,0,8,8
4602,PH141114000,VAMCO,2020,0,2,2
4603,PH142708000,VAMCO,2020,0,2,2
4604,PH142711000,VAMCO,2020,2,35,37
4605,PH142701000,VAMCO,2020,2,91,93
4606,PH142709000,VAMCO,2020,0,7,7
4607,PH142702000,VAMCO,2020,2,18,20
4608,PH142703000,VAMCO,2020,1,4,5
4609,PH142704000,VAMCO,2020,1,12,13
4610,PH142706000,VAMCO,2020,0,2,2
4611,PH142710000,VAMCO,2020,21,123,144
4612,PH143201000,VAMCO,2020,0,28,28
4613,PH143206000,VAMCO,2020,1,12,13
4614,PH143208000,VAMCO,2020,0,68,68
4615,PH143214000,VAMCO,2020,0,1,1
4616,PH143215000,VAMCO,2020,0,1,1
4617,PH144405000,VAMCO,2020,0,14,14
4618,PH144408000,VAMCO,2020,0,10,10
4619,PH144402000,VAMCO,2020,0,76,76
4620,PH144410000,VAMCO,2020,0,4,4
4621,PH012801000,Mangkhut,2018,1,297,298
4622,PH012802000,Mangkhut,2018,22,1834,1856
4623,PH012803000,Mangkhut,2018,194,2543,2737
4624,PH012804000,Mangkhut,2018,17,1149,1166
4625,PH012811000,Mangkhut,2018,46,776,822
4626,PH012805000,Mangkhut,2018,28,2798,2826
4627,PH012806000,Mangkhut,2018,27,588,615
4628,PH012807000,Mangkhut,2018,,29,29
4629,PH012808000,Mangkhut,2018,37,783,820
4630,PH012809000,Mangkhut,2018,31,540,571
4631,PH012810000,Mangkhut,2018,3,108,111
4632,PH012812000,Mangkhut,2018,355,3799,4154
4633,PH012813000,Mangkhut,2018,33,747,780
4634,PH012814000,Mangkhut,2018,52,677,729
4635,PH012815000,Mangkhut,2018,106,2588,2694
4636,PH012816000,Mangkhut,2018,110,1974,2084
4637,PH012817000,Mangkhut,2018,62,1521,1583
4638,PH012818000,Mangkhut,2018,26,399,425
4639,PH012819000,Mangkhut,2018,37,1052,1089
4640,PH012820000,Mangkhut,2018,70,989,1059
4641,PH012821000,Mangkhut,2018,30,643,673
4642,PH012822000,Mangkhut,2018,18,218,236
4643,PH012823000,Mangkhut,2018,24,1163,1187
4644,PH012901000,Mangkhut,2018,1,84,85
4645,PH012902000,Mangkhut,2018,55,862,917
4646,PH012903000,Mangkhut,2018,50,789,839
4647,PH012806000,Mangkhut,2018,42,1418,1460
4648,PH012905000,Mangkhut,2018,121,4353,4474
4649,PH012906000,Mangkhut,2018,33,2520,2553
4650,PH012907000,Mangkhut,2018,41,1383,1424
4651,PH012908000,Mangkhut,2018,3,291,294
4652,PH012909000,Mangkhut,2018,17,595,612
4653,PH012910000,Mangkhut,2018,9,235,244
4654,PH012911000,Mangkhut,2018,7,284,291
4655,PH012912000,Mangkhut,2018,151,2267,2418
4656,PH012913000,Mangkhut,2018,6,65,71
4657,PH012914000,Mangkhut,2018,63,3791,3854
4658,PH012915000,Mangkhut,2018,7,162,169
4659,PH012916000,Mangkhut,2018,3,54,57
4660,PH012917000,Mangkhut,2018,9,,9
4661,PH012918000,Mangkhut,2018,2,1407,1409
4662,PH012919000,Mangkhut,2018,,258,258
4663,PH012920000,Mangkhut,2018,52,1208,1260
4664,PH012921000,Mangkhut,2018,22,341,363
4665,PH012922000,Mangkhut,2018,33,880,913
4666,PH012923000,Mangkhut,2018,28,1033,1061
4667,PH012924000,Mangkhut,2018,27,815,842
4668,PH012925000,Mangkhut,2018,49,2409,2458
4669,PH012926000,Mangkhut,2018,57,2826,2883
4670,PH012927000,Mangkhut,2018,111,1851,1962
4671,PH012928000,Mangkhut,2018,54,1797,1851
4672,PH012929000,Mangkhut,2018,,33,33
4673,PH012930000,Mangkhut,2018,162,1635,1797
4674,PH012931000,Mangkhut,2018,,31,31
4675,PH012932000,Mangkhut,2018,5,340,345
4676,PH012933000,Mangkhut,2018,34,1163,1197
4677,PH012934000,Mangkhut,2018,101,2189,2290
4678,PH013301000,Mangkhut,2018,21,744,765
4679,PH013302000,Mangkhut,2018,80,321,401
4680,PH013303000,Mangkhut,2018,6,1016,1022
4681,PH013304000,Mangkhut,2018,12,468,480
4682,PH013305000,Mangkhut,2018,8,143,151
4683,PH013306000,Mangkhut,2018,255,207,462
4684,PH013307000,Mangkhut,2018,17,598,615
4685,PH013308000,Mangkhut,2018,2,70,72
4686,PH013309000,Mangkhut,2018,126,431,557
4687,PH013310000,Mangkhut,2018,10,1020,1030
4688,PH013311000,Mangkhut,2018,74,753,827
4689,PH013312000,Mangkhut,2018,2,8,10
4690,PH013313000,Mangkhut,2018,23,95,118
4691,PH013314000,Mangkhut,2018,10,238,248
4692,PH013315000,Mangkhut,2018,,16,16
4693,PH013316000,Mangkhut,2018,28,483,511
4694,PH013317000,Mangkhut,2018,10,152,162
4695,PH013318000,Mangkhut,2018,34,311,345
4696,PH013319000,Mangkhut,2018,2,8,10
4697,PH015501000,Mangkhut,2018,,241,241
4698,PH015502000,Mangkhut,2018,42,319,361
4699,PH015504000,Mangkhut,2018,,3,3
4700,PH015506000,Mangkhut,2018,5,21,26
4701,PH015507000,Mangkhut,2018,,57,57
4702,PH015509000,Mangkhut,2018,,28,28
4703,PH015510000,Mangkhut,2018,,1,1
4704,PH015512000,Mangkhut,2018,1,2,3
4705,PH015515000,Mangkhut,2018,3,,3
4706,PH015516000,Mangkhut,2018,3,292,295
4707,PH015517000,Mangkhut,2018,5,33,38
4708,PH015518000,Mangkhut,2018,48,791,839
4709,PH015520000,Mangkhut,2018,8,17,25
4710,PH015548000,Mangkhut,2018,5,116,121
4711,PH015522000,Mangkhut,2018,82,1192,1274
4712,PH015523000,Mangkhut,2018,9,792,801
4713,PH015524000,Mangkhut,2018,,2,2
4714,PH015525000,Mangkhut,2018,,2,2
4715,PH015526000,Mangkhut,2018,21,71,92
4716,PH015527000,Mangkhut,2018,5,160,165
4717,PH015528000,Mangkhut,2018,,6,6
4718,PH015530000,Mangkhut,2018,2,1,3
4719,PH015532000,Mangkhut,2018,1,52,53
4720,PH015533000,Mangkhut,2018,60,380,440
4721,PH015535000,Mangkhut,2018,1,33,34
4722,PH015536000,Mangkhut,2018,11,3,14
4723,PH015537000,Mangkhut,2018,2,1,3
4724,PH015538000,Mangkhut,2018,73,190,263
4725,PH015540000,Mangkhut,2018,1,,1
4726,PH015543000,Mangkhut,2018,2,5,7
4727,PH015547000,Mangkhut,2018,6,33,39
4728,PH021501000,Mangkhut,2018,595,6037,6632
4729,PH015504000,Mangkhut,2018,970,8423,9393
4730,PH021503000,Mangkhut,2018,1103,5338,6441
4731,PH021504000,Mangkhut,2018,2084,9340,11424
4732,PH021505000,Mangkhut,2018,897,9206,10103
4733,PH021506000,Mangkhut,2018,2249,13143,15392
4734,PH021507000,Mangkhut,2018,818,5880,6698
4735,PH021508000,Mangkhut,2018,434,3114,3548
4736,PH021509000,Mangkhut,2018,11,221,232
4737,PH021510000,Mangkhut,2018,349,2901,3250
4738,PH021511000,Mangkhut,2018,115,2305,2420
4739,PH021512000,Mangkhut,2018,118,2563,2681
4740,PH021513000,Mangkhut,2018,1250,9587,10837
4741,PH021514000,Mangkhut,2018,1225,6992,8217
4742,PH021515000,Mangkhut,2018,525,6835,7360
4743,PH021516000,Mangkhut,2018,690,6982,7672
4744,PH021517000,Mangkhut,2018,939,5527,6466
4745,PH021518000,Mangkhut,2018,143,1943,2086
4746,PH021519000,Mangkhut,2018,479,6217,6696
4747,PH021520000,Mangkhut,2018,453,3237,3690
4748,PH021521000,Mangkhut,2018,325,3587,3912
4749,PH021522000,Mangkhut,2018,238,4138,4376
4750,PH021523000,Mangkhut,2018,337,4295,4632
4751,PH021524000,Mangkhut,2018,34,470,504
4752,PH021525000,Mangkhut,2018,179,2479,2658
4753,PH021526000,Mangkhut,2018,577,5677,6254
4754,PH021527000,Mangkhut,2018,582,9166,9748
4755,PH021528000,Mangkhut,2018,386,10270,10656
4756,PH021529000,Mangkhut,2018,580,7694,8274
4757,PH023101000,Mangkhut,2018,18,91,109
4758,PH023102000,Mangkhut,2018,8,129,137
4759,PH023103000,Mangkhut,2018,3,151,154
4760,PH023104000,Mangkhut,2018,,182,182
4761,PH012806000,Mangkhut,2018,4,319,323
4762,PH023106000,Mangkhut,2018,45,707,752
4763,PH023107000,Mangkhut,2018,17,350,367
4764,PH023108000,Mangkhut,2018,19,356,375
4765,PH023109000,Mangkhut,2018,,22,22
4766,PH023118000,Mangkhut,2018,2,558,560
4767,PH023111000,Mangkhut,2018,18,207,225
4768,PH023112000,Mangkhut,2018,2,1,3
4769,PH023113000,Mangkhut,2018,11,259,270
4770,PH023114000,Mangkhut,2018,20,313,333
4771,PH013310000,Mangkhut,2018,11,249,260
4772,PH023117000,Mangkhut,2018,16,159,175
4773,PH023119000,Mangkhut,2018,5,249,254
4774,PH023120000,Mangkhut,2018,4,92,96
4775,PH023121000,Mangkhut,2018,10,814,824
4776,PH023122000,Mangkhut,2018,21,445,466
4777,PH023124000,Mangkhut,2018,,2,2
4778,PH023125000,Mangkhut,2018,2,75,77
4779,PH023126000,Mangkhut,2018,9,304,313
4780,PH023127000,Mangkhut,2018,1,21,22
4781,PH023128000,Mangkhut,2018,13,7,20
4782,PH023129000,Mangkhut,2018,2,2,4
4783,PH023130000,Mangkhut,2018,16,189,205
4784,PH023131000,Mangkhut,2018,,97,97
4785,PH023132000,Mangkhut,2018,,18,18
4786,PH023133000,Mangkhut,2018,2,29,31
4787,PH023134000,Mangkhut,2018,33,281,314
4788,PH023136000,Mangkhut,2018,57,538,595
4789,PH023137000,Mangkhut,2018,4,143,147
4790,PH025001000,Mangkhut,2018,1,65,66
4791,PH025002000,Mangkhut,2018,2,154,156
4792,PH025003000,Mangkhut,2018,,5,5
4793,PH025004000,Mangkhut,2018,2,20,22
4794,PH025005000,Mangkhut,2018,4,129,133
4795,PH025006000,Mangkhut,2018,3,13,16
4796,PH025007000,Mangkhut,2018,,16,16
4797,PH025008000,Mangkhut,2018,4,21,25
4798,PH025009000,Mangkhut,2018,,43,43
4799,PH025010000,Mangkhut,2018,7,283,290
4800,PH025011000,Mangkhut,2018,,57,57
4801,PH025012000,Mangkhut,2018,6,211,217
4802,PH025013000,Mangkhut,2018,2,159,161
4803,PH025701000,Mangkhut,2018,,84,84
4804,PH025702000,Mangkhut,2018,4,116,120
4805,PH025703000,Mangkhut,2018,8,55,63
4806,PH025704000,Mangkhut,2018,,2,2
4807,PH025706000,Mangkhut,2018,,5,5
4808,PH037701000,Mangkhut,2018,,1,1
4809,PH037702000,Mangkhut,2018,,6,6
4810,PH030802000,Mangkhut,2018,,4,4
4811,PH030805000,Mangkhut,2018,,5,5
4812,PH030807000,Mangkhut,2018,,5,5
4813,PH030808000,Mangkhut,2018,,7,7
4814,PH030810000,Mangkhut,2018,,3,3
4815,PH031402000,Mangkhut,2018,1,4,5
4816,PH031407000,Mangkhut,2018,1,100,101
4817,PH031410000,Mangkhut,2018,4,1,5
4818,PH031420000,Mangkhut,2018,,7,7
4819,PH034905000,Mangkhut,2018,13,148,161
4820,PH034906000,Mangkhut,2018,1,5,6
4821,PH034920000,Mangkhut,2018,2,4,6
4822,PH034921000,Mangkhut,2018,,2,2
4823,PH021521000,Mangkhut,2018,,19,19
4824,PH035402000,Mangkhut,2018,,2,2
4825,PH035405000,Mangkhut,2018,,1,1
4826,PH035413000,Mangkhut,2018,,5,5
4827,PH035417000,Mangkhut,2018,,3,3
4828,PH035420000,Mangkhut,2018,,2,2
4829,PH036903000,Mangkhut,2018,1,2,3
4830,PH036904000,Mangkhut,2018,,3,3
4831,PH036909000,Mangkhut,2018,3,3,6
4832,PH036914000,Mangkhut,2018,,3,3
4833,PH036917000,Mangkhut,2018,1,,1
4834,PH037101000,Mangkhut,2018,8,57,65
4835,PH037102000,Mangkhut,2018,,1,1
4836,PH037103000,Mangkhut,2018,45,344,389
4837,PH037105000,Mangkhut,2018,6,96,102
4838,PH037106000,Mangkhut,2018,25,498,523
4839,PH037108000,Mangkhut,2018,1,41,42
4840,PH037109000,Mangkhut,2018,,12,12
4841,PH037112000,Mangkhut,2018,3,30,33
4842,PH037113000,Mangkhut,2018,7,754,761
4843,PH140101000,Mangkhut,2018,158,3589,3747
4844,PH140103000,Mangkhut,2018,22,1092,1114
4845,PH140104000,Mangkhut,2018,,44,44
4846,PH140106000,Mangkhut,2018,33,825,858
4847,PH140107000,Mangkhut,2018,2,481,483
4848,PH140108000,Mangkhut,2018,59,1914,1973
4849,PH140109000,Mangkhut,2018,,23,23
4850,PH140110000,Mangkhut,2018,7,1101,1108
4851,PH140111000,Mangkhut,2018,5,761,766
4852,PH140112000,Mangkhut,2018,2,145,147
4853,PH140113000,Mangkhut,2018,4,147,151
4854,PH140114000,Mangkhut,2018,8,345,353
4855,PH140115000,Mangkhut,2018,,10,10
4856,PH140116000,Mangkhut,2018,9,1563,1572
4857,PH140117000,Mangkhut,2018,4,1079,1083
4858,PH140118000,Mangkhut,2018,5,1016,1021
4859,PH140119000,Mangkhut,2018,35,1106,1141
4860,PH140120000,Mangkhut,2018,6,295,301
4861,PH140121000,Mangkhut,2018,5,319,324
4862,PH140122000,Mangkhut,2018,38,636,674
4863,PH140123000,Mangkhut,2018,10,394,404
4864,PH140124000,Mangkhut,2018,26,672,698
4865,PH140125000,Mangkhut,2018,19,114,133
4866,PH140126000,Mangkhut,2018,,115,115
4867,PH140127000,Mangkhut,2018,5,173,178
4868,PH148101000,Mangkhut,2018,44,964,1008
4869,PH148102000,Mangkhut,2018,58,2550,2608
4870,PH148103000,Mangkhut,2018,135,2782,2917
4871,PH148104000,Mangkhut,2018,50,1363,1413
4872,PH148105000,Mangkhut,2018,151,3090,3241
4873,PH148106000,Mangkhut,2018,208,3093,3301
4874,PH148107000,Mangkhut,2018,71,2380,2451
4875,PH141101000,Mangkhut,2018,6,13,19
4876,PH141102000,Mangkhut,2018,112,322,434
4877,PH141103000,Mangkhut,2018,8,65,73
4878,PH141104000,Mangkhut,2018,49,276,325
4879,PH141105000,Mangkhut,2018,23,371,394
4880,PH141106000,Mangkhut,2018,149,928,1077
4881,PH141107000,Mangkhut,2018,20,267,287
4882,PH141108000,Mangkhut,2018,14,234,248
4883,PH141109000,Mangkhut,2018,9,50,59
4884,PH141110000,Mangkhut,2018,2,,2
4885,PH141111000,Mangkhut,2018,2,35,37
4886,PH141112000,Mangkhut,2018,7,69,76
4887,PH141113000,Mangkhut,2018,68,326,394
4888,PH141114000,Mangkhut,2018,9,225,234
4889,PH142708000,Mangkhut,2018,4,23,27
4890,PH142707000,Mangkhut,2018,,52,52
4891,PH142711000,Mangkhut,2018,3,25,28
4892,PH142701000,Mangkhut,2018,4,283,287
4893,PH142709000,Mangkhut,2018,,23,23
4894,PH142702000,Mangkhut,2018,4,86,90
4895,PH142703000,Mangkhut,2018,,29,29
4896,PH142704000,Mangkhut,2018,,41,41
4897,PH142705000,Mangkhut,2018,,35,35
4898,PH142706000,Mangkhut,2018,,38,38
4899,PH142710000,Mangkhut,2018,11,51,62
4900,PH143201000,Mangkhut,2018,20,460,480
4901,PH143206000,Mangkhut,2018,5,144,149
4902,PH143208000,Mangkhut,2018,8,184,192
4903,PH143209000,Mangkhut,2018,24,889,913
4904,PH143214000,Mangkhut,2018,,26,26
4905,PH143215000,Mangkhut,2018,1,37,38
4906,PH143211000,Mangkhut,2018,36,772,808
4907,PH143213000,Mangkhut,2018,10,147,157
4908,PH144404000,Mangkhut,2018,1,7,8
4909,PH144405000,Mangkhut,2018,1,234,235
4910,PH144406000,Mangkhut,2018,,65,65
4911,PH144408000,Mangkhut,2018,,16,16
4912,PH144402000,Mangkhut,2018,8,142,150
4913,PH144403000,Mangkhut,2018,3,50,53
4914,PH144407000,Mangkhut,2018,,10,10
4915,PH144409000,Mangkhut,2018,,5,5
4916,PH144410000,Mangkhut,2018,4,69,73
4917,PH060601000,JANGMI,2014,2,4,6
4918,PH184511000,JANGMI,2014,1,80,81
4919,PH184514000,JANGMI,2014,5,4,9
4920,PH184524000,JANGMI,2014,0,1,1
4921,PH184527000,JANGMI,2014,0,2,2
4922,PH071206000,JANGMI,2014,6,33,39
4923,PH071207000,JANGMI,2014,1,7,8
4924,PH071213000,JANGMI,2014,0,56,56
4925,PH071216000,JANGMI,2014,13,40,53
4926,PH071226000,JANGMI,2014,2,25,27
4927,PH071224000,JANGMI,2014,2,125,127
4928,PH071230000,JANGMI,2014,57,34,91
4929,PH071232000,JANGMI,2014,1,2,3
4930,PH072201000,JANGMI,2014,11,39,50
4931,PH072210000,JANGMI,2014,23,92,115
4932,PH072214000,JANGMI,2014,4,4,8
4933,PH072224000,JANGMI,2014,67,122,189
4934,PH072239000,JANGMI,2014,49,82,131
4935,PH082604000,JANGMI,2014,17,26,43
4936,PH083702000,JANGMI,2014,7,114,121
4937,PH083739000,JANGMI,2014,5,1,2
4938,PH083748000,JANGMI,2014,2,7,9
4939,PH083706000,JANGMI,2014,1,15,16
4940,PH083717000,JANGMI,2014,3,50,53
4941,PH083723000,JANGMI,2014,5,1,6
4942,PH086004000,JANGMI,2014,1,7,8
4943,PH086005000,JANGMI,2014,25,135,160
4944,PH086013000,JANGMI,2014,0,30,30
4945,PH097332000,JANGMI,2014,60,21,81
4946,PH086409000,JANGMI,2014,13,129,142
4947,PH101314000,JANGMI,2014,3,6,9
4948,PH101804000,JANGMI,2014,0,14,14
4949,PH101805000,JANGMI,2014,0,1,1
4950,PH104302000,JANGMI,2014,12,8,20
4951,PH104308000,JANGMI,2014,24,26,50
4952,PH104317000,JANGMI,2014,0,1,1
4953,PH104322000,JANGMI,2014,2,17,19
4954,PH104324000,JANGMI,2014,85,77,162
4955,PH118207000,JANGMI,2014,1,12,13
4956,PH160314000,JANGMI,2014,3,6,9
4957,PH160304000,JANGMI,2014,3,6,9
4958,PH168503000,JANGMI,2014,1,21,22
4959,PH166804000,JANGMI,2014,54,382,436
4960,PH166708000,JANGMI,2014,0,2,2
4961,PH166816000,JANGMI,2014,2,2,4
4962,PH012803000,LINFA,2015,1,6,7
4963,PH012805000,LINFA,2015,0,5,5
4964,PH012809000,LINFA,2015,0,1,1
4965,PH012817000,LINFA,2015,0,5,5
4966,PH012819000,LINFA,2015,0,14,14
4967,PH012823000,LINFA,2015,0,3,3
4968,PH012912000,LINFA,2015,0,12,12
4969,PH012916000,LINFA,2015,0,1,1
4970,PH012918000,LINFA,2015,0,7,7
4971,PH012927000,LINFA,2015,0,1,1
4972,PH012934000,LINFA,2015,2,0,2
4973,PH013310000,LINFA,2015,0,110,110
4974,PH013316000,LINFA,2015,2,17,19
4975,PH013318000,LINFA,2015,0,9,9
4976,PH140118000,LINFA,2015,1,4,5
4977,PH141110000,LINFA,2015,0,1,1
4978,PH143213000,LINFA,2015,1,1,2
4979,PH175324000,LINFA,2015,0,1,1
4980,PH072201000,TOKAGE,2016,0,2,2
4981,PH184505000,TOKAGE,2016,2,88,90
4982,PH175909000,TOKAGE,2016,2,0,2
4983,PH063023000,TOKAGE,2016,0,9,9
4984,PH020901000,MERANTI,2016,190,611,801
4985,PH020902000,MERANTI,2016,172,447,619
4986,PH020903000,MERANTI,2016,10,111,121
4987,PH020904000,MERANTI,2016,11,177,188
4988,PH020905000,MERANTI,2016,19,165,184
4989,PH020906000,MERANTI,2016,5,323,328
